SCHCD,Tch_Male,Tch_Female,Tch_NR,HeadTch,GradAbove,TchWithProf,DaysInvld,TchInvld
7010100101,23,27,0,0,49,50,633,48
7010100102,20,4,0,0,24,24,222,24
7010100103,15,4,0,0,16,19,46,4
7010100104,11,9,0,0,20,20,0,0
7010100105,7,77,0,0,76,84,0,0
7010100106,53,0,0,0,51,53,501,25
7010100107,0,23,0,0,21,23,0,0
7010100108,5,90,0,0,95,95,0,0
7010100109,18,19,0,0,36,37,98,18
7010100110,58,2,0,0,60,60,63,21
7010100201,55,5,0,0,57,60,0,0
7010100202,0,38,0,0,38,38,0,0
7010100301,15,21,0,0,36,36,30,14
7010100302,15,12,0,0,27,27,0,0
7010100303,1,23,0,0,23,24,0,0
7010100304,2,25,0,0,27,27,0,0
7010100305,2,34,0,0,34,36,0,0
7010100306,0,64,0,0,62,64,0,0
7010100307,15,13,0,0,28,28,10,1
7010100308,18,1,0,0,17,19,0,0
7010100309,52,0,0,0,52,52,89,3
7010100310,22,10,0,0,32,32,87,18
7010100311,16,5,0,0,21,21,0,0
7010100401,19,16,0,0,34,35,0,0
7010100402,3,55,0,0,54,58,0,0
7010100403,17,0,0,0,16,17,0,0
7010100404,33,1,0,0,34,34,0,0
7010100405,30,23,0,0,52,53,190,47
7010100501,2,19,0,0,20,21,0,0
7010100502,3,28,0,0,30,31,0,0
7010100503,1,75,0,0,66,76,420,2
7010100504,17,0,0,0,17,17,0,0
7010100505,99,1,0,0,99,100,0,0
7010100506,52,0,0,0,50,52,0,0
7010100701,43,0,0,0,42,43,0,0
7010100702,0,38,0,0,38,38,132,9
7010100703,24,10,0,0,32,34,4,1
7010101001,0,20,0,0,20,20,72,1
7010101002,15,0,0,0,15,15,435,10
7010101101,70,6,0,0,76,76,0,0
7010101201,3,29,0,0,30,32,0,0
7010101202,2,54,0,0,55,56,0,0
7010101203,0,43,0,0,41,43,0,0
7010101204,39,2,0,0,39,41,0,0
7010101205,38,1,0,0,37,39,0,0
7010101301,23,19,0,0,42,42,0,0
7010101401,20,1,0,0,21,21,0,0
7010101402,0,29,0,0,28,29,370,8
7010101403,41,0,0,0,39,41,0,0
7010101404,0,25,0,0,24,25,5,1
7010101405,0,68,0,0,68,68,0,0
7010101406,3,66,0,0,63,69,0,0
7010101407,48,0,0,0,48,48,0,0
7010101501,40,1,0,0,40,41,0,0
7010101601,2,72,0,0,74,74,0,0
7010101701,35,5,0,0,38,40,0,0
7010101702,0,72,0,0,71,72,0,0
7010101703,1,73,0,0,73,74,178,28
7010101704,61,5,0,0,66,66,80,5
7010101801,2,37,0,0,38,39,0,0
7010101802,46,0,0,0,46,46,125,3
7010101803,1,38,0,0,39,39,0,0
7010101804,25,4,0,0,29,29,115,23
7010101901,0,98,0,0,98,98,0,0
7010101902,14,1,0,0,13,15,0,0
7010102101,1,56,0,0,56,57,25,5
7010102102,0,49,0,0,48,49,0,0
7010102103,15,37,0,0,50,52,155,3
7010102104,17,55,0,0,72,72,0,0
7010102105,39,12,0,0,51,51,237,30
7010102202,12,15,0,0,27,27,0,0
7010102203,0,125,0,0,124,125,0,0
7010102204,40,2,0,0,41,42,33,7
7010102205,62,4,0,0,65,66,0,0
7010102206,34,58,0,0,90,92,0,0
7010102301,0,54,0,0,54,54,0,0
7010102302,3,79,0,0,82,82,1234,80
7010102303,57,0,0,0,57,57,0,0
7010102501,0,51,0,0,51,51,0,0
7010102502,1,77,0,0,70,78,0,0
7010102503,58,5,0,0,62,63,0,0
7010102504,41,3,0,0,44,44,61,29
7010102601,17,19,0,0,36,36,0,0
7010102602,63,0,0,0,63,63,0,0
7010102603,53,0,0,0,49,53,0,0
7010102701,0,56,0,0,56,56,0,0
7010102702,46,0,0,0,46,46,455,21
7010102703,6,9,0,0,14,15,22,11
7010102704,0,35,0,0,32,35,265,1
7010102705,22,0,0,0,22,22,20,1
7010102801,7,2,0,0,9,9,20,1
7010102802,3,39,0,0,42,42,0,0
7010102803,20,10,0,0,29,30,0,0
7010102804,38,9,0,0,47,47,80,16
7010102805,7,13,0,0,20,20,76,15
7010102806,9,3,0,0,12,12,0,0
7010102807,4,56,0,0,56,60,0,0
7010102808,2,31,0,0,30,33,0,0
7010102809,2,55,0,0,55,57,0,0
7010102810,12,3,0,0,15,15,0,0
7010102811,36,47,0,0,82,83,0,0
7010102812,48,2,0,0,50,50,0,0
7010102813,18,0,0,0,18,18,30,1
7010102814,26,0,0,0,25,26,0,0
7010102901,18,9,0,0,25,27,0,0
7010102902,28,0,0,0,28,28,0,0
7010102903,2,66,0,0,67,68,0,0
7010102904,3,44,0,0,37,47,0,0
7010102905,16,0,0,0,16,16,0,0
7010103001,16,4,0,0,19,20,0,0
7010103002,20,7,0,0,24,27,0,0
7010103003,16,6,0,0,21,22,0,0
7010103004,11,5,0,0,16,16,0,0
7010103005,13,23,0,0,33,36,0,0
7010103006,0,27,0,0,27,27,0,0
7010103007,24,30,0,0,53,54,55,1
7010103008,39,0,0,0,39,39,0,0
7010103301,0,20,0,0,20,20,0,0
7010103302,13,2,0,0,15,15,0,0
7010103401,47,0,0,0,47,47,111,18
7010103402,12,112,0,0,117,124,0,0
7010103403,92,1,0,0,91,93,667,66
7010103501,2,36,0,0,35,38,16,2
7010103701,32,4,0,0,35,36,40,2
7010103702,0,41,0,0,41,41,1355,22
7010103703,2,96,0,0,89,98,32,3
7010103704,4,92,0,0,83,96,0,0
7010103705,59,0,0,0,58,59,0,0
7010103706,34,0,0,0,34,34,0,0
7010103707,56,0,0,0,54,56,0,0
7010103708,42,27,0,0,62,69,3,1
7010103801,1,66,0,0,66,67,315,46
7010103802,20,2,0,0,22,22,0,0
7010103901,0,34,0,0,34,34,36,6
7010103902,0,25,0,0,25,25,0,0
7010103903,22,0,0,0,21,22,0,0
7010103904,18,25,0,0,43,43,0,0
7010103905,9,6,0,0,15,15,0,0
7010104001,23,3,0,0,26,26,0,0
7010104002,16,3,0,0,19,19,0,0
7010104501,32,35,0,0,67,67,0,0
7010104502,34,60,0,0,93,94,0,0
7010104601,18,1,0,0,19,19,30,15
7010104602,1,69,0,0,67,70,335,45
7010104603,34,47,0,0,74,81,0,0
7010104604,27,0,0,0,27,27,0,0
7010104701,29,2,0,0,30,31,119,26
7010104702,36,36,0,0,62,72,0,0
7010104703,15,26,0,0,39,41,0,0
7010104704,13,39,0,0,52,52,220,1
7010104705,1,71,0,0,70,72,620,57
7010104706,40,0,0,0,38,40,0,0
7010104707,73,2,0,0,74,75,9,4
7010104802,0,58,0,0,55,58,182,48
7010104804,1,73,0,0,69,74,246,15
7010104805,54,0,0,0,53,54,0,0
7010104806,33,0,0,0,33,33,0,0
7010104901,12,31,0,0,41,43,0,0
7010105101,15,45,0,0,60,60,0,0
7010105102,39,4,0,0,42,43,0,0
7010105201,15,58,0,0,69,73,0,0
7010105301,16,49,0,0,62,65,665,2
7010105402,0,33,0,0,33,33,30,11
7010105403,17,44,0,0,60,61,0,0
7010105404,19,2,0,0,21,21,0,0
7010105501,1,53,0,0,52,54,0,0
7010105502,0,32,0,0,32,32,0,0
7010105503,1,30,0,0,30,31,0,0
7010105504,29,1,0,0,30,30,240,25
7010105505,23,5,0,0,28,28,49,1
7010105601,10,16,0,0,26,26,154,20
7010105602,0,35,0,0,34,35,0,0
7010105603,6,28,0,0,31,34,450,15
7010105604,24,0,0,0,24,24,0,0
7010105605,17,44,0,0,54,61,0,0
7010105606,21,5,0,0,26,26,0,0
7010105901,7,17,0,0,24,24,0,0
7010105902,0,45,0,0,45,45,0,0
7010105903,28,1,0,0,29,29,0,0
7010106001,11,36,0,0,47,47,0,0
7010106002,12,37,0,0,47,49,458,13
7010106003,0,35,0,0,35,35,0,0
7010106004,12,44,0,0,55,56,168,43
7010106101,1,24,0,0,25,25,0,0
7010106102,16,2,0,0,18,18,201,5
7010106201,0,42,0,0,42,42,0,0
7010106202,1,30,0,0,29,31,74,19
7010106203,0,45,0,0,44,45,0,0
7010106204,7,4,0,0,11,11,0,0
7010106205,34,7,0,0,38,41,70,4
7010106301,0,29,0,0,29,29,30,3
7010106302,44,3,0,0,41,47,0,0
7010106401,0,39,0,0,39,39,0,0
7010106402,25,2,0,0,26,27,60,1
7010106502,2,74,0,0,73,76,0,0
7010106601,0,44,0,0,44,44,77,17
7010106701,9,17,0,0,26,26,0,0
7010106702,0,43,0,0,41,43,0,0
7010106703,1,56,0,0,50,57,0,0
7010106704,42,5,0,0,47,47,0,0
7010106705,1,39,0,0,39,40,12,3
7010106706,31,1,0,0,32,32,0,0
7010106707,22,0,0,0,21,22,0,0
7010106801,0,34,0,0,34,34,0,0
7010106802,1,60,0,0,56,61,0,0
7010106803,1,58,0,0,53,59,154,33
7010106804,27,0,0,0,27,27,540,9
7010106805,24,2,0,0,26,26,380,4
7010106806,21,1,0,0,21,22,204,17
7010106807,35,4,0,0,38,39,57,12
7010107001,29,5,0,0,34,34,0,0
7010107002,14,8,0,0,22,22,0,0
7010107101,3,38,0,0,37,41,0,0
7010107102,23,0,0,0,23,23,3893,17
7010107201,35,0,0,0,35,35,0,0
7010107202,0,29,0,0,29,29,35,7
7010107203,0,33,0,0,33,33,80,26
7010107204,1,56,0,0,53,57,0,0
7010107205,31,1,0,0,32,32,0,0
7010107206,36,1,0,0,37,37,0,0
7010107207,43,21,0,0,62,64,0,0
7010201301,25,6,0,0,31,31,0,0
7010201302,0,64,0,0,63,64,0,0
7010201701,11,1,0,0,12,12,0,0
7010201801,17,0,0,0,17,17,0,0
7010202601,12,3,0,0,13,15,0,0
7010202801,4,5,0,0,9,9,0,0
7010202902,16,0,0,0,16,16,105,13
7010204001,27,20,0,0,47,47,0,0
7010206701,0,21,0,0,21,21,0,0
7010300101,10,41,0,0,51,51,0,0
7010300102,11,26,0,0,37,37,0,0
7010300103,2,22,0,0,21,24,0,0
7010300104,2,14,0,0,14,16,0,0
7010300105,19,29,0,0,47,48,10560,48
7010300201,0,16,0,0,14,16,381,16
7010300202,2,9,0,0,11,11,0,0
7010300203,2,16,0,0,18,18,0,0
7010300204,4,14,0,0,18,18,0,0
7010300302,1,8,0,0,9,9,0,0
7010300303,2,29,0,0,27,31,0,0
7010300304,2,8,0,0,8,10,0,0
7010300305,0,6,0,1,4,6,0,0
7010300306,11,59,0,0,69,70,2179,45
7010300307,4,21,0,0,25,25,143,25
7010300308,0,26,0,0,21,26,0,0
7010300309,25,25,0,1,49,50,1223,42
7010300310,6,19,0,0,22,25,0,0
7010300311,1,11,0,0,6,12,0,0
7010300312,4,15,0,0,18,19,0,0
7010300313,5,10,0,0,13,15,42,14
7010300314,1,13,0,0,14,14,0,0
7010300401,7,16,0,0,20,23,0,0
7010300402,13,41,0,1,54,54,0,0
7010300403,2,12,0,0,6,14,37,14
7010300404,6,6,0,0,11,12,0,0
7010300405,6,8,0,0,12,14,120,14
7010300406,8,16,0,0,16,24,1200,24
7010300407,2,7,0,0,8,9,0,0
7010300501,0,12,0,1,6,12,0,0
7010301101,3,41,0,0,42,44,0,0
7010301201,0,9,0,1,8,9,0,0
7010301202,1,43,0,0,44,44,858,42
7010301203,1,12,0,0,12,13,0,0
7010301301,14,67,0,2,79,81,0,0
7010301401,0,18,0,1,18,18,0,0
7010301402,0,28,0,0,28,28,0,0
7010301403,0,9,0,1,8,9,23,8
7010301404,1,47,0,0,47,48,0,0
7010301405,3,8,0,1,8,11,0,0
7010301501,1,18,0,0,19,19,0,0
7010301701,0,9,0,1,7,9,0,0
7010301702,0,11,0,1,7,11,1370,10
7010301703,0,13,0,1,13,13,0,0
7010301704,1,14,0,0,14,15,0,0
7010301801,3,6,0,1,7,9,0,0
7010301802,3,6,0,0,6,9,0,0
7010301803,1,8,0,1,6,9,0,0
7010301804,1,13,0,0,13,14,0,0
7010301805,3,25,0,0,27,28,0,0
7010301806,5,8,0,0,12,13,0,0
7010301807,4,7,0,1,11,11,0,0
7010301808,2,9,0,0,8,11,0,0
7010302101,9,53,0,0,61,62,0,0
7010302102,11,60,0,0,71,71,792,71
7010302103,10,76,0,2,86,86,220,1
7010302104,9,55,0,0,64,64,0,0
7010302105,1,18,0,0,19,19,0,0
7010302106,0,27,0,1,27,27,0,0
7010302107,11,43,0,0,52,54,432,54
7010302108,0,29,0,0,26,29,0,0
7010302109,0,24,0,0,24,24,0,0
7010302110,3,27,0,0,30,30,0,0
7010302111,2,21,0,0,23,23,0,0
7010302112,0,9,0,1,9,9,0,0
7010302113,0,33,0,0,33,33,0,0
7010302114,1,8,0,0,9,9,0,0
7010302201,1,9,0,1,10,10,0,0
7010302202,6,28,0,0,33,34,1164,34
7010302203,3,38,0,0,41,41,430,38
7010302204,1,96,0,2,97,97,0,0
7010302205,3,20,0,0,23,23,0,0
7010302206,2,53,0,0,55,55,0,0
7010302207,5,44,0,0,46,49,1170,48
7010302208,4,106,0,0,110,110,0,0
7010302209,1,57,0,0,58,58,2900,58
7010302302,4,7,0,1,7,11,0,0
7010302303,5,22,0,0,26,27,1000,25
7010302304,4,16,0,0,19,20,324,18
7010302305,5,19,0,0,23,24,0,0
7010302306,1,40,0,0,40,41,0,0
7010302307,5,6,0,0,7,11,31,11
7010302308,0,9,0,1,9,9,0,0
7010302309,3,12,0,0,14,15,0,0
7010302310,3,12,0,0,13,15,0,0
7010302311,2,9,0,1,7,11,0,0
7010302312,1,15,0,1,15,16,48,16
7010302313,3,10,0,0,8,13,0,0
7010302401,2,13,0,0,15,15,0,0
7010302402,2,27,0,1,29,29,0,0
7010302403,0,10,0,1,9,10,0,0
7010302501,2,8,0,1,10,10,0,0
7010302503,2,11,0,0,13,13,0,0
7010302504,14,12,0,0,25,26,0,0
7010302505,2,26,0,0,28,28,0,0
7010302506,15,103,0,0,118,118,775,118
7010302507,6,9,0,0,15,15,0,0
7010302508,3,17,0,0,15,20,0,0
7010302509,4,115,0,0,119,119,0,0
7010302510,5,55,0,2,60,60,0,0
7010302511,3,16,0,0,19,19,0,0
7010302601,12,51,0,1,62,63,0,0
7010302602,0,9,0,0,9,9,0,0
7010302603,1,16,0,0,16,17,0,0
7010302604,0,12,0,1,12,12,0,0
7010302605,0,10,0,0,7,10,0,0
7010302606,14,76,0,1,90,90,0,0
7010302701,3,18,0,0,16,21,0,0
7010302702,4,9,0,1,11,13,0,0
7010302703,3,12,0,0,12,15,310,15
7010302704,7,5,0,1,10,12,36,12
7010302705,14,24,0,0,37,38,3,1
7010302706,9,29,0,0,35,38,0,0
7010302707,4,12,0,0,12,16,0,0
7010302708,6,10,0,0,16,16,115,15
7010302709,3,4,0,0,7,7,0,0
7010302710,7,9,0,0,11,16,0,0
7010302711,2,13,0,1,12,15,0,0
7010302712,5,5,0,1,10,10,0,0
7010302713,5,12,0,0,9,17,144,16
7010302802,1,14,0,0,15,15,0,0
7010302804,3,26,0,0,29,29,10,1
7010302805,4,11,0,0,13,15,80,15
7010302806,8,40,0,0,47,48,720,48
7010302807,25,28,0,0,48,53,0,0
7010302808,8,27,0,0,31,35,0,0
7010302809,3,12,0,0,13,15,0,0
7010302810,3,7,0,1,9,10,0,0
7010302811,0,10,0,1,10,10,0,0
7010302812,6,9,0,0,15,15,0,0
7010302901,4,25,0,0,16,29,0,0
7010302903,6,14,0,1,9,20,0,0
7010302904,11,15,0,0,21,26,0,0
7010302905,3,13,0,0,14,16,0,0
7010302907,3,27,0,0,30,30,0,0
7010302908,5,10,0,0,15,15,304,15
7010302909,2,21,0,0,21,23,0,0
7010302910,6,5,0,0,6,11,0,0
7010302913,2,32,0,0,21,34,0,0
7010302914,5,7,0,0,5,12,36,12
7010303001,9,25,0,0,32,34,465,31
7010303002,6,23,0,0,29,29,87,11
7010303003,7,21,0,0,28,28,0,0
7010303004,5,7,0,1,12,12,275,11
7010303005,1,10,0,1,11,11,0,0
7010303006,0,11,0,1,11,11,220,11
7010303007,4,13,0,0,17,17,0,0
7010303008,0,12,0,1,11,12,49,12
7010303009,6,6,0,0,12,12,0,0
7010303010,4,9,0,0,9,13,0,0
7010303011,3,12,0,0,15,15,0,0
7010303012,4,6,0,1,5,10,0,0
7010303013,5,41,0,0,34,46,0,0
7010303301,5,22,0,0,26,27,243,27
7010303302,5,11,0,0,13,16,58,12
7010303401,6,13,0,0,18,19,0,0
7010303402,5,7,0,1,11,12,59,12
7010303403,5,13,0,0,14,18,205,10
7010303404,10,23,0,0,29,33,99,33
7010303405,5,14,0,0,17,19,0,0
7010303501,4,8,0,1,12,12,0,0
7010303502,0,12,0,1,12,12,0,0
7010303503,4,15,0,1,17,19,168,15
7010303601,5,8,0,1,6,13,0,0
7010303801,3,17,0,0,17,20,53,20
7010303901,12,24,0,0,35,36,432,36
7010304001,6,6,0,1,11,12,0,0
7010304002,5,10,0,0,10,15,0,0
7010304003,9,3,0,1,12,12,0,0
7010304501,2,23,0,1,23,25,0,0
7010304502,1,8,0,1,8,9,114,9
7010304503,11,104,0,0,114,115,0,0
7010304504,5,50,0,0,55,55,0,0
7010304505,15,43,0,1,54,58,2842,58
7010304506,1,10,0,1,11,11,0,0
7010304507,14,58,0,0,71,72,0,0
7010304508,5,25,0,0,30,30,50,2
7010304509,3,70,0,0,72,73,0,0
7010304901,4,68,0,0,69,72,334,72
7010304902,10,57,0,0,65,67,0,0
7010304903,1,12,0,0,13,13,365,1
7010304904,0,8,0,1,8,8,0,0
7010304905,6,23,0,0,29,29,0,0
7010305001,3,141,0,1,144,144,0,0
7010305002,6,45,0,0,51,51,0,0
7010305003,2,47,0,0,49,49,4,1
7010305101,1,36,0,0,37,37,0,0
7010305102,17,103,0,0,119,120,0,0
7010305103,2,14,0,0,16,16,0,0
7010305201,0,9,0,1,9,9,0,0
7010305202,1,16,0,0,17,17,0,0
7010305301,6,103,0,1,109,109,215,1
7010305302,16,37,0,0,53,53,0,0
7010305303,0,14,0,0,14,14,90,1
7010305304,5,29,0,1,32,34,5,1
7010305305,0,8,0,0,7,8,0,0
7010305401,4,71,0,2,69,75,0,0
7010305402,4,29,0,0,33,33,117,33
7010305404,0,38,0,0,37,38,370,37
7010305405,11,156,0,0,161,167,0,0
7010305406,16,71,0,1,82,87,0,0
7010305407,11,68,0,2,79,79,269,78
7010305408,9,35,0,0,43,44,129,43
7010305409,0,27,0,0,27,27,0,0
7010305410,1,37,0,0,38,38,0,0
7010305411,0,10,0,1,10,10,0,0
7010305412,0,7,0,1,7,7,0,0
7010305413,8,72,0,0,79,80,1990,77
7010305415,2,27,0,0,29,29,0,0
7010305501,3,28,0,0,30,31,0,0
7010305502,9,77,0,1,81,86,0,0
7010305503,1,13,0,0,14,14,238,13
7010305504,0,8,0,1,8,8,0,0
7010305505,2,26,0,0,24,28,41,13
7010305601,10,69,0,1,79,79,1760,79
7010305602,0,11,0,1,11,11,96,11
7010305603,6,71,0,1,77,77,0,0
7010305604,6,85,0,0,88,91,1429,91
7010305605,2,27,0,0,28,29,0,0
7010305606,4,36,0,0,40,40,0,0
7010305607,16,133,0,0,146,149,3259,149
7010305901,0,4,0,1,4,4,0,0
7010305902,0,8,0,1,8,8,0,0
7010305903,1,7,0,1,8,8,0,0
7010305904,0,8,0,1,8,8,92,8
7010306001,12,150,0,2,161,162,0,0
7010306002,2,12,0,0,14,14,0,0
7010306003,13,137,0,0,139,150,5,1
7010306005,7,39,0,1,45,46,0,0
7010306006,4,23,0,0,26,27,0,0
7010306007,5,47,0,2,50,52,590,52
7010306008,1,15,0,0,16,16,236,16
7010306009,2,12,0,0,13,14,207,1
7010306010,0,23,0,0,23,23,0,0
7010306011,8,70,0,0,77,78,0,0
7010306012,2,23,0,0,25,25,2,1
7010306101,0,4,0,1,4,4,0,0
7010306103,1,11,0,1,12,12,0,0
7010306104,0,12,0,1,12,12,0,0
7010306105,2,12,0,1,14,14,0,0
7010306501,8,91,0,2,99,99,0,0
7010306502,8,71,0,0,78,79,0,0
7010306601,1,7,0,1,8,8,0,0
7010306602,6,71,0,1,75,77,0,0
7010306701,3,77,0,0,80,80,0,0
7010306702,0,10,0,0,10,10,22,1
7010306703,1,13,0,0,13,14,0,0
7010306801,2,15,0,0,17,17,0,0
7010306802,4,19,0,0,22,23,28,22
7010306803,0,24,0,0,23,24,622,23
7010306804,15,228,0,2,238,243,0,0
7010306805,1,37,0,0,38,38,25,1
7010306806,14,76,0,0,80,90,0,0
7010307001,11,109,0,2,118,120,0,0
7010307002,0,2,0,1,2,2,0,0
7010307101,7,49,0,0,53,56,0,0
7010307201,1,3,0,0,4,4,0,0
7010307202,4,76,0,0,78,80,0,0
7010307203,7,28,0,0,35,35,528,35
7010307204,6,42,0,0,47,48,0,0
7010307205,2,32,0,0,34,34,220,1
7010307206,10,21,0,0,31,31,0,0
7010307207,17,73,0,1,81,90,0,0
7010307208,0,11,0,1,10,11,0,0
7010307209,3,21,0,1,22,24,0,0
7010307210,0,9,0,1,9,9,15,1
7010310001,3,28,0,1,29,31,0,0
7010400101,6,13,0,1,18,19,0,0
7010400102,7,18,0,1,23,25,5,1
7010400103,12,2,0,1,14,14,0,0
7010400104,4,10,0,1,14,14,15,1
7010400105,4,4,0,1,8,8,5,1
7010400106,2,3,0,1,4,5,0,0
7010400107,0,15,0,1,11,15,0,0
7010400108,3,3,0,1,6,6,0,0
7010400109,0,6,0,1,3,6,0,0
7010400110,5,0,0,1,5,5,0,0
7010400111,0,7,0,1,6,7,0,0
7010400112,7,5,0,1,9,12,150,6
7010400113,0,15,0,1,10,15,0,0
7010400114,7,0,0,1,6,7,15,1
7010400115,0,11,0,1,10,11,0,0
7010400116,4,2,0,1,4,6,0,0
7010400117,0,8,0,1,7,8,0,0
7010400118,5,12,0,1,8,17,0,0
7010400119,0,20,0,1,16,20,0,0
7010400201,1,13,0,1,12,14,0,0
7010400202,4,1,0,1,4,5,0,0
7010400203,6,5,0,1,7,11,230,9
7010400204,0,10,0,1,8,10,0,0
7010400205,2,5,0,1,7,7,15,1
7010400206,1,16,0,1,16,17,0,0
7010400207,5,12,0,1,15,17,0,0
7010400208,6,8,0,1,7,14,0,0
7010400209,2,11,0,1,11,13,0,0
7010400301,15,0,0,0,5,15,0,0
7010400302,10,1,0,1,11,11,0,0
7010400303,4,4,0,0,6,8,0,0
7010400304,15,0,0,0,9,15,24,8
7010400305,0,11,0,1,11,11,0,0
7010400306,0,5,0,1,5,5,0,0
7010400307,5,0,0,1,3,5,0,0
7010400308,12,0,0,1,8,12,166,5
7010400309,4,10,0,1,13,14,0,0
7010400310,12,8,0,1,20,20,0,0
7010400311,12,0,0,1,7,12,0,0
7010400312,4,12,0,1,11,16,0,0
7010400313,1,4,0,1,5,5,0,0
7010400314,0,4,0,1,4,4,0,0
7010400315,3,0,0,1,0,3,0,0
7010400316,3,2,0,1,5,5,0,0
7010400317,0,13,0,1,11,13,7,1
7010400318,8,3,0,1,10,11,0,0
7010400319,6,8,0,1,7,14,0,0
7010400320,2,15,0,1,15,17,15,1
7010400321,0,13,0,1,13,13,0,0
7010400322,12,5,0,1,12,17,0,0
7010400401,12,4,0,1,10,16,0,0
7010400402,7,8,0,1,15,15,0,0
7010400403,10,12,0,1,18,22,0,0
7010400404,0,8,0,1,7,8,0,0
7010400405,5,2,0,1,3,7,0,0
7010400406,0,2,0,1,1,2,0,0
7010400407,1,1,0,1,2,2,0,0
7010400408,2,1,0,1,2,3,0,0
7010400409,5,0,0,1,5,5,2,1
7010400410,6,6,0,1,11,12,0,0
7010400411,1,3,0,1,3,4,0,0
7010400412,5,0,0,1,4,5,0,0
7010400413,10,1,0,1,9,11,0,0
7010400414,3,1,0,1,3,4,12,4
7010400415,2,1,0,1,3,3,0,0
7010400416,1,2,0,1,3,3,0,0
7010400417,3,1,0,1,4,4,0,0
7010400418,1,6,0,1,5,7,0,0
7010400419,2,4,0,1,4,6,0,0
7010400420,3,0,0,1,2,3,0,0
7010400421,3,4,0,1,6,7,0,0
7010400501,3,10,0,1,11,13,0,0
7010400502,5,3,0,1,6,8,0,0
7010400503,7,3,0,1,9,10,0,0
7010400504,0,20,0,1,19,20,0,0
7010400505,12,7,0,1,10,19,0,0
7010400506,0,15,0,1,12,15,0,0
7010400507,11,0,0,1,6,11,0,0
7010400508,1,5,0,1,5,6,0,0
7010400509,5,1,0,0,5,6,0,0
7010400510,0,24,0,1,19,24,0,0
7010400701,4,1,0,1,4,5,0,0
7010400702,3,3,0,1,3,6,0,0
7010401101,2,17,0,1,19,19,0,0
7010401102,0,10,0,1,10,10,0,0
7010401103,1,11,0,1,11,12,15,1
7010401104,0,5,0,1,5,5,0,0
7010401201,0,5,0,1,4,5,0,0
7010401202,2,4,0,1,6,6,0,0
7010401203,1,4,0,1,4,5,0,0
7010401204,0,5,0,1,5,5,0,0
7010401205,5,0,0,1,5,5,0,0
7010401206,0,5,0,1,5,5,0,0
7010401207,1,3,0,1,3,4,0,0
7010401208,1,10,0,1,9,11,0,0
7010401209,0,11,0,1,11,11,0,0
7010401301,2,4,0,1,5,6,0,0
7010401302,2,9,0,1,11,11,0,0
7010401303,6,0,0,1,6,6,0,0
7010401304,8,12,0,1,20,20,0,0
7010401305,2,15,0,1,16,17,0,0
7010401306,2,3,0,1,5,5,16,4
7010401307,6,13,0,1,17,19,0,0
7010401401,15,10,0,1,11,25,0,0
7010401402,0,9,0,1,9,9,0,0
7010401403,4,5,0,1,9,9,0,0
7010401404,1,33,0,1,23,34,0,0
7010401405,11,13,0,1,14,24,0,0
7010401406,0,5,0,1,4,5,0,0
7010401407,0,5,0,1,5,5,0,0
7010401408,7,2,0,1,9,9,0,0
7010401501,4,14,0,1,15,18,0,0
7010401502,0,16,0,1,12,16,0,0
7010401503,6,9,0,1,9,15,0,0
7010401504,1,2,0,1,3,3,0,0
7010401601,11,3,0,1,14,14,0,0
7010401602,0,9,0,1,8,9,20,2
7010401603,3,3,0,1,6,6,0,0
7010401604,1,27,0,0,20,28,15,1
7010401605,9,7,0,1,12,16,0,0
7010401606,0,9,0,1,7,9,0,0
7010401607,7,2,0,1,8,9,0,0
7010401608,0,13,0,0,10,13,0,0
7010401701,0,16,0,1,15,16,0,0
7010401702,3,10,0,1,10,13,0,0
7010401703,4,18,0,1,12,22,0,0
7010401704,8,5,0,1,6,13,0,0
7010401705,0,15,0,1,12,15,16,1
7010401706,6,5,0,1,3,11,0,0
7010401801,3,27,0,1,12,30,0,0
7010401802,11,13,0,1,8,24,0,0
7010401803,3,17,0,1,12,20,0,0
7010401804,16,4,0,1,12,20,0,0
7010401805,5,31,0,1,24,36,0,0
7010401806,18,7,0,1,14,25,0,0
7010401901,4,25,0,1,17,29,0,0
7010401902,12,8,0,1,5,20,0,0
7010401903,3,14,0,1,15,17,30,1
7010401904,8,2,0,1,6,10,0,0
7010401905,10,29,0,1,12,39,0,0
7010401906,24,6,0,1,19,30,12,1
7010401907,8,6,0,1,14,14,0,0
7010401908,14,3,0,1,6,17,0,0
7010401909,15,3,0,1,11,18,0,0
7010402001,0,26,0,1,6,26,0,0
7010402002,12,5,0,1,11,17,0,0
7010402003,7,6,0,0,7,13,0,0
7010402004,1,27,0,1,28,28,0,0
7010402005,11,10,0,1,21,21,0,0
7010402006,1,14,0,1,13,15,0,0
7010402101,1,29,0,1,20,30,0,0
7010402102,2,24,0,1,23,26,0,0
7010402103,0,14,0,1,14,14,0,0
7010402104,2,16,0,1,16,18,0,0
7010402105,1,16,0,1,15,17,0,0
7010402106,2,15,0,1,14,17,0,0
7010402201,19,10,0,1,18,29,28,4
7010402202,4,13,0,1,13,17,0,0
7010402203,1,25,0,1,25,26,0,0
7010402205,3,21,0,1,18,24,0,0
7010402206,2,27,0,1,27,29,0,0
7010402301,10,14,0,1,19,24,5,1
7010402302,0,30,0,1,30,30,0,0
7010402502,10,21,0,1,24,31,0,0
7010402503,0,23,0,1,17,23,0,0
7010402504,14,11,0,1,15,25,0,0
7010402505,0,16,0,1,13,16,0,0
7010402506,16,1,0,1,12,17,0,0
7010402507,11,5,0,1,14,16,0,0
7010402508,2,16,0,1,13,18,0,0
7010402509,3,16,0,1,14,19,0,0
7010402510,0,31,0,1,25,31,0,0
7010402511,1,25,0,1,23,26,0,0
7010402512,17,4,0,1,13,21,0,0
7010402513,16,3,0,1,11,19,15,1
7010402514,10,1,0,1,8,11,0,0
7010402601,13,7,0,1,14,20,0,0
7010402602,18,0,0,1,13,18,0,0
7010402603,0,20,0,1,14,20,0,0
7010402604,2,5,0,1,6,7,0,0
7010402605,2,31,0,1,23,33,15,1
7010402606,9,40,0,1,43,49,0,0
7010402607,16,5,0,1,6,21,85,17
7010402608,1,18,0,1,16,19,15,1
7010402609,0,12,0,1,11,12,0,0
7010402610,7,4,0,1,7,11,0,0
7010402701,3,8,0,1,7,11,0,0
7010402702,8,16,0,0,11,24,0,0
7010402703,2,29,0,1,30,31,0,0
7010402704,12,4,0,1,7,16,0,0
7010402705,0,21,0,1,18,21,0,0
7010402706,1,2,0,1,1,3,0,0
7010402707,4,2,0,1,4,6,0,0
7010402708,1,1,0,1,0,2,0,0
7010402709,3,2,0,1,4,5,0,0
7010402710,3,12,0,1,10,15,3,1
7010402711,4,9,0,1,6,13,0,0
7010402712,0,11,0,1,10,11,0,0
7010402801,9,0,0,1,6,9,0,0
7010402802,0,15,0,0,7,15,0,0
7010402803,8,2,0,1,6,10,0,0
7010402804,9,10,0,1,16,19,0,0
7010402805,9,3,0,0,12,12,0,0
7010402806,6,2,0,1,7,8,0,0
7010402807,3,8,0,1,7,11,0,0
7010402808,10,12,0,0,16,22,0,0
7010402809,6,3,0,1,6,9,0,0
7010402810,1,13,0,1,11,14,0,0
7010402811,1,2,0,1,3,3,0,0
7010402813,3,2,0,1,5,5,0,0
7010402814,1,4,0,1,3,5,0,0
7010402815,3,2,0,1,0,5,0,0
7010402816,0,5,0,1,3,5,0,0
7010402817,3,2,0,1,5,5,0,0
7010402818,1,4,0,1,3,5,0,0
7010402819,1,4,0,1,3,5,0,0
7010402820,3,1,0,0,4,4,0,0
7010402821,0,5,0,1,5,5,0,0
7010402822,3,1,0,1,2,4,15,1
7010402823,0,4,0,0,3,4,0,0
7010402824,1,3,0,1,4,4,0,0
7010402825,1,4,0,1,3,5,0,0
7010402826,4,1,0,1,2,5,0,0
7010402827,11,6,0,1,9,17,0,0
7010402828,0,5,0,1,5,5,0,0
7010402829,3,2,0,1,4,5,0,0
7010402830,0,17,0,1,9,17,0,0
7010402831,5,15,0,1,16,20,0,0
7010402901,3,2,0,1,4,5,135,3
7010402902,0,7,0,1,6,7,0,0
7010402903,0,21,0,1,15,21,0,0
7010402904,10,4,0,1,14,14,0,0
7010402905,2,0,0,1,0,2,0,0
7010402906,3,1,0,1,3,4,0,0
7010402907,1,2,0,1,3,3,0,0
7010402908,0,5,0,1,5,5,0,0
7010402909,2,3,0,0,4,5,0,0
7010402910,0,11,0,1,5,11,0,0
7010402911,2,6,0,0,4,8,0,0
7010403001,3,0,0,1,1,3,0,0
7010403002,18,6,0,1,12,24,0,0
7010403003,4,33,0,1,20,37,0,0
7010403004,5,1,0,1,5,6,2,1
7010403005,0,8,0,1,7,8,0,0
7010403006,4,1,0,1,3,5,0,0
7010403007,0,5,0,1,5,5,0,0
7010403008,3,1,0,1,4,4,0,0
7010403009,7,4,0,1,8,11,0,0
7010403010,0,8,0,1,8,8,0,0
7010403011,0,3,0,1,3,3,0,0
7010403012,2,1,0,1,3,3,0,0
7010403013,4,6,0,1,5,10,0,0
7010403014,10,2,0,1,10,12,0,0
7010403015,7,0,0,1,2,7,0,0
7010403016,11,3,0,1,13,14,0,0
7010403301,8,21,0,1,20,29,0,0
7010403401,24,2,0,1,11,26,0,0
7010403402,17,18,0,0,17,35,54,4
7010403403,14,17,0,1,20,31,0,0
7010403404,20,0,0,0,17,20,0,0
7010403501,21,0,0,1,7,21,0,0
7010403502,16,24,0,1,21,40,0,0
7010403601,15,0,0,0,9,15,0,0
7010403701,20,0,0,0,20,20,0,0
7010403702,10,0,0,1,7,10,0,0
7010403703,3,8,0,1,8,11,0,0
7010403704,8,2,0,1,10,10,0,0
7010403705,6,6,0,1,5,12,0,0
7010403706,14,0,0,1,9,14,0,0
7010403707,8,16,0,1,17,24,97,7
7010403708,10,0,0,1,10,10,10,1
7010403709,3,7,0,1,5,10,0,0
7010403710,8,0,0,1,4,8,0,0
7010403711,1,8,0,1,8,9,0,0
7010403712,9,0,0,1,4,9,0,0
7010403713,1,9,0,1,6,10,0,0
7010403801,7,3,0,1,10,10,0,0
7010403802,1,10,0,1,11,11,0,0
7010403803,9,4,0,1,13,13,0,0
7010403804,4,9,0,1,13,13,0,0
7010403805,10,1,0,1,11,11,0,0
7010403806,3,9,0,1,12,12,0,0
7010403807,11,10,0,1,19,21,0,0
7010403808,17,0,0,1,17,17,0,0
7010403809,7,13,0,1,20,20,25,5
7010403901,12,15,0,1,19,27,0,0
7010403902,14,14,0,1,13,28,0,0
7010403903,14,0,0,1,10,14,0,0
7010403904,4,14,0,1,18,18,0,0
7010404001,5,0,0,1,5,5,0,0
7010404002,4,1,0,1,5,5,0,0
7010404003,26,0,0,1,16,26,0,0
7010404004,8,17,0,1,25,25,0,0
7010404005,17,0,0,1,15,17,0,0
7010404006,0,20,0,1,20,20,0,0
7010404007,10,0,0,1,7,10,0,0
7010404401,24,1,0,1,20,25,12,2
7010404501,5,5,0,1,8,10,0,0
7010404502,0,11,0,1,7,11,0,0
7010404503,2,14,0,0,16,16,21,1
7010404504,3,8,0,1,9,11,0,0
7010404505,0,10,0,1,10,10,0,0
7010404506,3,11,0,1,11,14,0,0
7010404507,2,17,0,0,13,19,0,0
7010404508,0,22,0,1,21,22,0,0
7010404601,0,16,0,1,16,16,0,0
7010404602,8,1,0,1,9,9,0,0
7010404603,15,1,0,1,16,16,0,0
7010404604,0,17,0,1,17,17,0,0
7010404605,11,1,0,1,12,12,0,0
7010404606,0,13,0,1,13,13,0,0
7010404701,9,4,0,1,12,13,20,4
7010404702,11,0,0,1,11,11,0,0
7010404703,1,10,0,1,11,11,0,0
7010404704,7,0,0,1,7,7,0,0
7010404705,0,11,0,1,11,11,0,0
7010404706,12,0,0,0,10,12,0,0
7010404707,2,11,0,1,8,13,0,0
7010404708,8,0,0,1,8,8,0,0
7010404709,4,8,0,1,12,12,0,0
7010404710,16,0,0,1,16,16,0,0
7010404711,1,11,0,1,12,12,15,1
7010404712,0,11,0,1,11,11,0,0
7010404713,3,9,0,1,9,12,45,3
7010404801,7,8,0,1,10,15,0,0
7010404802,10,0,0,1,8,10,0,0
7010404803,4,5,0,1,7,9,0,0
7010404804,11,0,0,1,5,11,0,0
7010404805,0,12,0,1,11,12,0,0
7010404806,7,1,0,1,7,8,2,1
7010404807,3,7,0,1,7,10,0,0
7010404808,12,0,0,1,10,12,0,0
7010404809,2,8,0,1,9,10,0,0
7010404810,10,1,0,1,9,11,0,0
7010404811,2,9,0,1,6,11,0,0
7010404901,16,2,0,1,13,18,0,0
7010404902,0,12,0,1,10,12,0,0
7010404903,0,14,0,1,14,14,0,0
7010404904,3,40,0,1,39,43,869,29
7010404905,0,16,0,1,15,16,0,0
7010405001,0,12,0,1,11,12,0,0
7010405002,1,18,0,1,19,19,0,0
7010405101,1,12,0,1,12,13,30,6
7010405201,0,16,0,1,14,16,0,0
7010405202,2,15,0,1,14,17,109,15
7010405203,0,13,0,1,13,13,0,0
7010405204,1,15,0,1,15,16,0,0
7010405301,0,16,0,1,16,16,0,0
7010405302,0,19,0,1,16,19,141,18
7010405303,0,12,0,1,12,12,0,0
7010405401,10,8,0,1,13,18,60,1
7010405402,0,30,0,1,25,30,140,7
7010405403,0,5,0,1,5,5,0,0
7010405404,0,9,0,1,9,9,0,0
7010405405,0,6,0,1,5,6,0,0
7010405406,1,7,0,1,8,8,0,0
7010405407,0,5,0,1,5,5,0,0
7010405501,3,11,0,1,11,14,0,0
7010405502,0,16,0,1,15,16,0,0
7010405503,4,21,0,1,19,25,2,1
7010405504,1,13,0,1,11,14,0,0
7010405505,5,20,0,1,23,25,0,0
7010405506,0,5,0,1,5,5,0,0
7010405507,0,13,0,1,13,13,0,0
7010405601,5,5,0,1,9,10,0,0
7010405602,1,16,0,1,14,17,0,0
7010405603,0,8,0,1,5,8,0,0
7010405604,0,13,0,1,12,13,11,4
7010405605,0,19,0,1,18,19,0,0
7010405606,1,5,0,1,5,6,0,0
7010405901,0,18,0,1,15,18,0,0
7010405902,6,12,0,1,15,18,0,0
7010406001,0,16,0,1,16,16,0,0
7010406101,1,18,0,1,15,19,0,0
7010406102,1,3,0,1,2,4,20,1
7010406103,0,5,0,1,4,5,0,0
7010406104,1,11,0,1,12,12,0,0
7010406105,0,14,0,1,13,14,33,2
7010406201,4,5,0,1,6,9,0,0
7010406202,0,15,0,1,12,15,33,4
7010406203,9,1,0,1,9,10,0,0
7010406204,0,11,0,1,10,11,0,0
7010406205,4,12,0,1,15,16,0,0
7010406206,4,1,0,1,2,5,0,0
7010406207,0,5,0,1,5,5,0,0
7010406208,0,4,0,1,0,4,0,0
7010406301,0,14,0,1,12,14,0,0
7010406302,0,12,0,1,10,12,0,0
7010406401,0,21,0,1,20,21,0,0
7010406402,0,4,0,1,4,4,0,0
7010406403,6,14,0,1,11,20,0,0
7010406404,4,3,0,1,6,7,0,0
7010406405,0,13,0,1,12,13,0,0
7010406406,5,9,0,1,13,14,0,0
7010406407,4,4,0,1,8,8,0,0
7010406408,5,14,0,1,17,19,0,0
7010406501,4,6,0,1,9,10,0,0
7010406502,1,15,0,1,16,16,0,0
7010406503,9,2,0,0,6,11,0,0
7010406504,0,19,0,1,16,19,0,0
7010406505,5,4,0,1,4,9,0,0
7010406506,0,17,0,1,14,17,0,0
7010406601,0,8,0,1,7,8,0,0
7010406602,2,2,0,0,4,4,0,0
7010406603,1,9,0,1,9,10,72,9
7010406604,2,17,0,1,17,19,0,0
7010406605,1,11,0,1,12,12,0,0
7010406606,0,5,0,1,5,5,6,1
7010406607,0,6,0,1,6,6,0,0
7010406608,0,5,0,1,5,5,0,0
7010406609,0,5,0,1,4,5,0,0
7010406701,2,4,0,1,6,6,0,0
7010406702,0,8,0,1,8,8,0,0
7010406703,0,10,0,1,10,10,15,1
7010406704,3,2,0,1,4,5,0,0
7010406705,0,18,0,1,17,18,0,0
7010406706,1,15,0,1,15,16,3,1
7010406801,5,0,0,1,5,5,0,0
7010406802,0,2,0,1,2,2,0,0
7010406803,0,4,0,1,4,4,0,0
7010406804,4,15,0,1,16,19,0,0
7010406805,8,15,0,1,21,23,5,1
7010406806,0,6,0,1,6,6,0,0
7010407001,0,11,0,1,8,11,0,0
7010407002,1,6,0,1,5,7,0,0
7010407003,0,5,0,1,5,5,0,0
7010407004,1,3,0,1,1,4,0,0
7010407005,1,4,0,1,5,5,0,0
7010407006,2,8,0,1,7,10,0,0
7010407101,1,13,0,1,14,14,15,1
7010407102,6,3,0,1,6,9,0,0
7010407103,0,5,0,1,4,5,0,0
7010407104,3,2,0,1,4,5,0,0
7010407105,11,3,0,1,10,14,0,0
7010407106,7,5,0,1,6,12,0,0
7010407201,0,7,0,1,6,7,0,0
7010407202,3,3,0,1,2,6,0,0
7010407203,0,7,0,1,7,7,0,0
7010407204,1,3,0,1,2,4,0,0
7010407205,3,2,0,1,4,5,0,0
7010407206,0,5,0,1,5,5,0,0
7010407207,0,12,0,1,10,12,0,0
7010407208,6,3,0,1,7,9,0,0
7010501201,1,2,0,0,3,3,0,0
7010600102,0,6,0,1,6,6,0,0
7010600103,0,11,0,1,5,11,0,0
7010600104,0,5,0,1,5,5,15,1
7010600105,1,7,0,1,7,8,32,8
7010600201,3,2,0,1,5,5,0,0
7010600202,0,5,0,1,1,5,0,0
7010600203,1,4,0,1,5,5,0,0
7010600204,0,10,0,1,6,10,15,1
7010600205,2,3,0,1,1,5,0,0
7010600301,0,4,0,1,4,4,4,2
7010600302,1,13,0,1,8,14,0,0
7010600303,1,10,0,1,7,11,0,0
7010600304,0,5,0,1,1,5,0,0
7010600305,2,3,0,1,0,5,19,3
7010600306,3,2,0,1,5,5,0,0
7010600401,1,4,0,1,5,5,6,1
7010601401,2,5,0,1,3,7,0,0
7010601701,0,15,0,1,9,15,0,0
7010601702,2,7,0,0,9,9,0,0
7010601703,2,5,0,1,4,7,0,0
7010601704,2,3,0,1,2,5,0,0
7010601801,1,5,0,1,6,6,0,0
7010601802,0,5,0,1,3,5,0,0
7010601803,2,10,0,1,11,12,0,0
7010601804,0,5,0,1,5,5,0,0
7010601901,0,6,0,1,3,6,0,0
7010601902,0,18,0,1,18,18,0,0
7010602102,0,5,0,1,5,5,0,0
7010602104,1,4,0,1,5,5,0,0
7010602105,0,7,0,1,2,7,0,0
7010602106,0,5,0,1,2,5,0,0
7010602301,0,5,0,1,0,5,0,0
7010602302,0,7,0,1,6,7,0,0
7010602304,0,5,0,1,5,5,0,0
7010602305,0,4,0,0,4,4,0,0
7010602306,0,7,0,1,0,7,0,0
7010602401,0,5,0,1,3,5,0,0
7010602402,1,6,0,1,7,7,0,0
7010602403,0,6,0,1,4,6,0,0
7010602501,0,5,0,1,5,5,0,0
7010602601,0,5,0,1,0,5,0,0
7010602602,2,3,0,1,5,5,50,5
7010602603,1,4,0,1,5,5,240,4
7010602604,1,4,0,1,2,5,548,4
7010602801,5,3,0,1,4,8,0,0
7010602803,0,5,0,1,5,5,0,0
7010602901,0,5,0,1,4,5,0,0
7010602902,1,4,0,1,5,5,0,0
7010603001,0,5,0,1,5,5,0,0
7010603002,1,5,0,1,3,6,0,0
7010603003,2,7,0,1,9,9,0,0
7010603004,1,3,0,1,4,4,0,0
7010603005,3,2,0,1,0,5,0,0
7010603301,3,5,0,1,6,8,0,0
7010603302,0,5,0,1,5,5,0,0
7010603303,2,3,0,1,1,5,0,0
7010603401,0,5,0,1,5,5,0,0
7010603501,0,8,0,1,6,8,0,0
7010603502,3,2,0,1,5,5,0,0
7010603503,4,3,0,1,1,7,0,0
7010603504,0,5,0,1,0,5,0,0
7010603505,0,5,0,1,4,5,0,0
7010603506,3,3,0,1,0,6,0,0
7010603507,1,5,0,1,4,6,0,0
7010603508,1,7,0,1,0,8,0,0
7010603601,4,4,0,1,0,8,0,0
7010603602,4,3,0,1,7,7,0,0
7010603701,0,5,0,1,5,5,0,0
7010603702,1,5,0,1,1,6,0,0
7010604001,0,5,0,1,5,5,0,0
7010604501,0,7,0,1,2,7,82,7
7010605201,0,15,0,1,13,15,0,0
7010605301,0,5,0,1,5,5,0,0
7010605401,0,3,0,1,2,3,0,0
7010605901,0,5,0,1,4,5,0,0
7010605902,0,5,0,1,5,5,0,0
7010605904,0,5,0,1,5,5,0,0
7010605905,0,4,0,1,4,4,0,0
7010605906,0,5,0,1,4,5,0,0
7010605907,0,5,0,1,3,5,0,0
7010605908,0,5,0,1,4,5,0,0
7010605910,2,3,0,1,5,5,0,0
7010606001,0,20,0,1,19,20,0,0
7010606002,1,4,0,1,5,5,0,0
7010606102,0,5,0,1,5,5,0,0
7010606103,0,5,0,1,4,5,1120,5
7010606104,0,3,0,1,3,3,0,0
7010606105,0,5,0,1,5,5,0,0
7010606106,0,5,0,1,5,5,0,0
7010606301,1,3,0,1,4,4,0,0
7010606401,0,11,0,0,8,11,0,0
7010606701,0,5,0,1,5,5,0,0
7010606702,0,5,0,0,5,5,0,0
7010606801,0,6,0,1,4,6,0,0
7010607001,0,5,0,1,5,5,0,0
7010900101,8,9,0,0,16,17,0,0
7010900201,23,18,0,1,39,41,300,1
7010902101,22,48,0,0,69,70,0,0
7010904501,23,28,0,1,51,51,0,0
7010904502,11,14,0,0,25,25,140,8
7010904503,17,19,0,1,36,36,12,1
7010905101,27,72,0,2,95,99,0,0
7010905601,16,53,0,1,65,69,0,0
7010905901,21,59,0,0,80,80,0,0
7010906702,27,29,0,2,54,56,54,3
7011002801,15,10,0,0,24,25,0,0
7020100601,4,0,0,0,4,4,0,0
7020100701,38,0,0,0,38,38,0,0
7020100702,1,53,0,0,53,54,43,3
7020100703,40,0,0,0,40,40,0,0
7020100704,3,32,0,0,35,35,270,1
7020100705,1,85,0,0,84,86,0,0
7020100706,91,2,0,0,92,93,0,0
7020100707,29,4,0,0,28,33,0,0
7020100902,2,50,0,0,49,52,945,45
7020100903,1,43,0,0,38,44,0,0
7020100904,29,1,0,0,26,30,0,0
7020101001,23,0,0,0,23,23,0,0
7020101002,1,69,0,0,65,70,0,0
7020101003,32,20,0,0,49,52,0,0
7020101004,52,3,0,0,52,55,285,46
7020101101,9,54,0,0,56,63,0,0
7020106901,0,65,0,0,57,65,64,2
7020106902,15,0,0,0,15,15,7,1
7020106903,39,1,0,0,39,40,0,0
7020106904,27,6,0,0,32,33,0,0
7020106905,0,26,0,0,26,26,210,1
7020107001,0,32,0,0,30,32,300,1
7020107002,37,0,0,0,35,37,559,31
7020107003,3,58,0,0,60,61,0,0
7020107004,36,1,0,0,37,37,0,0
7020107005,28,19,0,0,45,47,0,0
7020107301,31,1,0,0,28,32,91,21
7020107302,1,48,0,0,44,49,0,0
7020107303,2,29,0,0,31,31,0,0
7020107304,0,35,0,0,35,35,0,0
7020107401,0,50,0,0,46,50,0,0
7020107402,20,0,0,0,20,20,0,0
7020107403,1,33,0,0,23,34,0,0
7020107404,28,0,0,0,28,28,0,0
7020107501,12,11,0,0,23,23,435,22
7020107502,1,40,0,0,39,41,0,0
7020107503,17,29,0,0,44,46,0,0
7020107504,27,1,0,0,28,28,51,1
7020107601,0,11,0,0,11,11,0,0
7020107602,8,3,0,0,9,11,0,0
7020107603,0,21,0,0,18,21,222,13
7020107701,42,2,0,0,42,44,60,19
7020107702,28,12,0,0,38,40,0,0
7020107703,0,22,0,0,22,22,0,0
7020107704,22,13,0,0,33,35,0,0
7020107705,1,14,0,0,15,15,0,0
7020107706,37,3,0,0,37,40,0,0
7020107801,26,1,0,0,27,27,4,1
7020107802,38,12,0,0,50,50,370,2
7020107803,1,21,0,0,19,22,0,0
7020107804,35,10,0,0,45,45,0,0
7020108001,0,7,0,0,7,7,0,0
7020108002,0,15,0,0,14,15,0,0
7020108003,7,4,0,0,11,11,0,0
7020108801,0,12,0,0,12,12,0,0
7020108802,0,10,0,0,10,10,0,0
7020108803,0,38,0,0,33,38,0,0
7020108804,10,1,0,0,11,11,0,0
7020108805,32,3,0,0,32,35,0,0
7020200901,0,9,0,0,9,9,0,0
7020200902,10,1,0,0,10,11,0,0
7020201001,1,13,0,1,11,14,112,14
7020206902,0,2,0,1,2,2,0,0
7020206903,1,17,0,0,14,18,0,0
7020206904,5,5,0,0,10,10,190,10
7020206905,8,17,0,0,25,25,0,0
7020206906,2,4,0,1,6,6,0,0
7020206907,24,0,0,0,24,24,0,0
7020206908,0,21,0,0,21,21,715,21
7020207001,13,10,0,0,22,23,0,0
7020207301,8,4,0,0,12,12,0,0
7020207302,0,14,0,0,14,14,520,13
7020207501,22,0,0,0,20,22,0,0
7020207601,2,2,0,0,4,4,0,0
7020207602,7,11,0,0,14,18,280,1
7020207603,0,32,0,0,32,32,2287,30
7020207604,9,6,0,0,15,15,0,0
7020207605,0,10,0,0,10,10,41,1
7020207606,1,0,0,0,1,1,0,0
7020207607,0,30,0,0,30,30,0,0
7020207608,0,26,0,0,26,26,0,0
7020207801,0,20,0,0,20,20,0,0
7020207802,9,9,0,0,18,18,0,0
7020207803,0,46,0,0,39,46,0,0
7020207804,6,28,0,0,34,34,0,0
7020207805,0,16,0,0,15,16,134,10
7020207807,9,24,0,0,31,33,0,0
7020207808,0,7,0,0,7,7,0,0
7020208001,1,51,0,1,49,52,5,1
7020208002,0,17,0,1,17,17,595,17
7020208003,21,0,0,0,20,21,0,0
7020208004,0,16,0,0,16,16,0,0
7020208005,6,0,0,0,6,6,216,6
7020208006,7,12,0,0,19,19,0,0
7020208007,0,5,0,0,5,5,0,0
7020208501,10,8,0,0,18,18,0,0
7020208601,12,0,0,0,12,12,432,12
7020208602,0,10,0,0,10,10,0,0
7020208603,20,3,0,0,21,23,0,0
7020208801,15,19,0,0,32,34,0,0
7020208802,14,0,0,0,14,14,0,0
7020208803,6,11,0,0,15,17,680,17
7020209101,1,23,0,0,24,24,0,0
7020212901,0,32,0,0,30,32,0,0
7020300601,3,8,0,1,11,11,0,0
7020300701,3,71,0,0,74,74,8,2
7020300702,2,37,0,0,39,39,0,0
7020300703,3,27,0,0,28,30,0,0
7020300801,15,28,0,1,42,43,0,0
7020300802,0,16,0,0,15,16,0,0
7020300803,37,38,0,0,74,75,0,0
7020300804,0,11,0,0,11,11,0,0
7020300805,5,37,0,0,35,42,0,0
7020300806,3,12,0,1,15,15,197,15
7020300807,3,11,0,1,6,14,0,0
7020300808,6,8,0,1,14,14,15,1
7020300809,6,11,0,0,10,17,0,0
7020301001,2,13,0,1,15,15,0,0
7020301002,9,32,0,0,38,41,0,0
7020301003,0,9,0,1,9,9,0,0
7020301004,0,16,0,0,16,16,351,16
7020306901,0,33,0,0,32,33,363,33
7020306902,0,29,0,1,29,29,0,0
7020306903,6,84,0,0,88,90,1278,88
7020307001,0,15,0,1,15,15,0,0
7020307501,0,12,0,1,12,12,75,2
7020307601,0,11,0,1,11,11,0,0
7020307701,5,21,0,0,24,26,0,0
7020307801,18,90,0,0,107,108,0,0
7020307802,9,38,0,0,36,47,225,45
7020308001,9,57,0,1,63,66,0,0
7020308201,0,7,0,0,7,7,0,0
7020400601,14,12,0,0,26,26,0,0
7020400602,10,27,0,1,18,37,0,0
7020400603,15,0,0,1,15,15,0,0
7020400701,16,11,0,1,19,27,0,0
7020400702,0,12,0,1,6,12,0,0
7020400703,13,0,0,1,13,13,0,0
7020400704,15,9,0,1,17,24,0,0
7020400705,11,1,0,1,12,12,0,0
7020400706,9,8,0,1,14,17,0,0
7020400801,12,24,0,1,27,36,1059,27
7020400802,3,7,0,1,10,10,60,4
7020400804,22,5,0,1,27,27,0,0
7020400805,3,34,0,1,28,37,0,0
7020400901,2,3,0,1,4,5,15,1
7020400902,1,6,0,1,6,7,10,4
7020400904,0,3,0,1,3,3,6,2
7020400905,0,5,0,1,5,5,0,0
7020400906,2,7,0,1,9,9,0,0
7020400908,2,5,0,1,7,7,0,0
7020400909,3,2,0,1,4,5,0,0
7020400910,2,2,0,1,2,4,6,1
7020400911,0,5,0,1,5,5,0,0
7020401001,3,1,0,1,4,4,0,0
7020401002,0,6,0,1,6,6,0,0
7020401003,3,8,0,1,11,11,0,0
7020401004,3,7,0,1,8,10,0,0
7020401005,3,1,0,1,4,4,0,0
7020401006,0,7,0,1,7,7,0,0
7020401007,6,5,0,1,8,11,15,1
7020401101,9,2,0,1,8,11,0,0
7020401102,0,9,0,1,6,9,0,0
7020401108,8,3,0,1,7,11,0,0
7020406901,0,4,0,1,4,4,0,0
7020406902,1,3,0,1,2,4,6,2
7020406903,0,4,0,1,4,4,0,0
7020406904,0,5,0,1,4,5,0,0
7020406905,2,2,0,1,2,4,0,0
7020406906,0,2,0,1,2,2,0,0
7020406907,0,4,0,1,3,4,0,0
7020406908,1,4,0,1,4,5,0,0
7020406909,0,5,0,1,5,5,0,0
7020406910,0,4,0,1,4,4,0,0
7020407001,2,4,0,1,6,6,0,0
7020407301,0,6,0,1,6,6,0,0
7020407302,2,3,0,1,4,5,0,0
7020407303,0,5,0,1,5,5,0,0
7020407304,0,5,0,1,3,5,0,0
7020407305,0,6,0,1,6,6,72,6
7020407306,4,1,0,1,2,5,0,0
7020407307,1,12,0,1,11,13,31,1
7020407308,0,5,0,1,5,5,0,0
7020407309,1,4,0,1,5,5,0,0
7020407401,0,6,0,1,4,6,0,0
7020407402,3,2,0,1,4,5,0,0
7020407403,2,4,0,1,5,6,50,4
7020407404,0,7,0,1,5,7,0,0
7020407405,2,4,0,1,6,6,0,0
7020407406,0,12,0,1,5,12,0,0
7020407407,4,5,0,1,8,9,0,0
7020407408,0,5,0,1,3,5,0,0
7020407409,2,2,0,1,4,4,0,0
7020407410,0,10,0,1,8,10,0,0
7020407411,3,3,0,1,4,6,0,0
7020407412,0,10,0,0,8,10,0,0
7020407413,5,4,0,1,9,9,0,0
7020407501,1,5,0,1,5,6,48,6
7020407502,3,2,0,1,5,5,0,0
7020407503,0,5,0,1,4,5,0,0
7020407504,1,4,0,1,5,5,0,0
7020407505,3,2,0,1,5,5,20,1
7020407506,5,1,0,1,6,6,19,2
7020407507,1,4,0,1,3,5,0,0
7020407508,0,5,0,1,4,5,0,0
7020407509,2,10,0,1,9,12,0,0
7020407510,1,7,0,1,7,8,0,0
7020407511,1,4,0,1,5,5,0,0
7020407512,1,3,0,0,4,4,0,0
7020407513,1,4,0,1,4,5,0,0
7020407514,5,4,0,1,6,9,0,0
7020407601,1,3,0,1,3,4,0,0
7020407602,1,4,0,1,5,5,0,0
7020407603,0,3,0,1,3,3,0,0
7020407604,2,1,0,1,3,3,15,1
7020407605,1,2,0,1,3,3,0,0
7020407606,2,2,0,1,3,4,0,0
7020407607,1,2,0,1,3,3,0,0
7020407608,1,3,0,1,4,4,19,2
7020407609,1,4,0,1,5,5,0,0
7020407610,0,2,0,1,2,2,0,0
7020407701,4,6,0,1,10,10,0,0
7020407702,2,4,0,1,1,6,0,0
7020407703,2,1,0,1,3,3,0,0
7020407704,1,3,0,1,3,4,0,0
7020407801,2,3,0,1,5,5,0,0
7020407802,7,0,0,1,5,7,0,0
7020407803,0,13,0,1,13,13,0,0
7020407804,0,4,0,1,4,4,10,1
7020407805,0,2,0,1,2,2,0,0
7020408001,2,1,0,1,3,3,0,0
7020408002,2,2,0,1,4,4,5,1
7020408003,1,1,0,1,2,2,0,0
7020408004,0,3,0,1,3,3,0,0
7020408005,4,1,0,1,4,5,15,1
7020408006,2,1,0,1,3,3,0,0
7020408007,1,2,0,1,3,3,0,0
7020408008,1,1,0,1,2,2,10,2
7020408501,1,1,0,0,2,2,0,0
7020408502,2,2,0,1,4,4,0,0
7020408503,0,3,0,1,3,3,0,0
7020408701,2,3,0,1,4,5,0,0
7020408801,0,4,0,1,4,4,0,0
7020408802,4,1,0,1,3,5,0,0
7020408803,0,6,0,1,6,6,0,0
7020408804,4,0,0,1,3,4,0,0
7020408805,2,6,0,1,7,8,0,0
7020408806,4,2,0,1,5,6,0,0
7020408807,1,3,0,1,4,4,0,0
7020408808,3,2,0,1,4,5,0,0
7020408809,2,4,0,1,6,6,0,0
7020408810,0,5,0,1,3,5,0,0
7020408811,1,3,0,1,4,4,0,0
7020408812,1,4,0,1,5,5,0,0
7020409001,0,5,0,1,3,5,0,0
7020409002,4,0,0,1,4,4,0,0
7020409003,0,5,0,1,5,5,0,0
7020409004,1,3,0,1,3,4,15,1
7020409005,3,0,0,1,3,3,0,0
7020508001,0,5,0,1,5,5,0,0
7020508501,0,9,0,1,9,9,0,0
7020508801,0,1,0,0,1,1,0,0
7020600602,2,10,0,1,6,12,0,0
7020600603,1,4,0,1,1,5,0,0
7020600604,0,6,0,1,6,6,0,0
7020600605,3,5,0,1,2,8,40,8
7020600606,0,5,0,1,5,5,0,0
7020600701,0,5,0,1,5,5,0,0
7020600702,1,4,0,1,5,5,0,0
7020600703,2,6,0,1,0,8,0,0
7020600704,2,3,0,1,5,5,0,0
7020600705,0,5,0,1,5,5,0,0
7020600706,2,3,0,1,5,5,0,0
7020600707,3,2,0,1,0,5,0,0
7020600802,0,5,0,1,1,5,0,0
7020600803,3,6,0,1,7,9,0,0
7020600805,6,4,0,1,10,10,0,0
7020600901,0,7,0,1,7,7,0,0
7020600902,0,6,0,1,4,6,56,5
7020600903,0,7,0,1,7,7,0,0
7020601002,0,5,0,1,5,5,1095,5
7020607301,0,5,0,1,5,5,0,0
7020607401,0,5,0,1,3,5,0,0
7020607501,0,5,0,1,3,5,0,0
7020607601,0,6,0,1,3,6,0,0
7020607701,0,5,0,1,3,5,0,0
7020607801,0,5,0,1,5,5,0,0
7020607802,0,8,0,1,6,8,0,0
7020608001,0,2,0,0,2,2,0,0
7020608801,0,5,0,1,5,5,0,0
7030123401,3,32,0,0,24,35,0,0
7030123402,25,6,0,0,18,31,0,0
7030123701,1,65,0,0,66,66,0,0
7030123702,1,11,0,0,11,12,0,0
7030123703,0,59,0,0,59,59,0,0
7030123704,65,0,0,0,62,65,0,0
7030124001,3,21,0,0,24,24,0,0
7030124002,34,0,0,0,34,34,50,1
7030124101,0,86,0,0,86,86,0,0
7030124102,1,97,0,0,96,98,0,0
7030124103,76,0,0,0,76,76,183,2
7030124104,62,2,0,0,64,64,0,0
7030124105,92,0,0,0,91,92,0,0
7030124201,1,102,0,0,96,103,0,0
7030124202,74,0,0,0,74,74,0,0
7030124203,59,0,0,0,59,59,0,0
7030124204,6,65,0,0,68,71,66,22
7030124301,2,40,0,0,42,42,468,3
7030124302,0,42,0,0,41,42,0,0
7030124303,91,0,0,0,91,91,0,0
7030124304,21,11,0,0,32,32,14,2
7030124305,48,0,0,0,48,48,0,0
7030124306,1,87,0,0,88,88,30,1
7030124307,6,78,0,0,82,84,0,0
7030124308,1,87,0,0,87,88,220,1
7030124309,9,69,0,0,76,78,0,0
7030124310,33,1,0,0,34,34,0,0
7030124311,104,0,0,0,95,104,132,46
7030124601,73,0,0,0,71,73,0,0
7030124602,2,27,0,0,29,29,0,0
7030124603,3,88,0,0,91,91,0,0
7030124604,25,0,0,0,25,25,0,0
7030124701,4,54,0,0,57,58,2,1
7030124702,2,48,0,0,48,50,0,0
7030124703,38,0,0,0,33,38,4,1
7030124704,42,1,0,0,43,43,0,0
7030124705,0,18,0,0,18,18,48,18
7030124706,21,0,0,0,21,21,8,1
7030124707,9,0,0,0,9,9,60,1
7030124708,47,3,0,0,50,50,0,0
7030124801,0,30,0,0,30,30,0,0
7030124802,0,35,0,0,35,35,0,0
7030124901,17,1,0,0,18,18,0,0
7030125001,7,106,0,0,110,113,0,0
7030125002,53,0,0,0,53,53,0,0
7030125003,1,53,0,0,48,54,91,17
7030125005,17,0,0,0,17,17,0,0
7030125006,21,0,0,0,21,21,200,1
7030125007,33,0,0,0,33,33,90,18
7030125008,0,8,0,0,8,8,0,0
7030125101,2,48,0,0,50,50,2,1
7030125102,1,26,0,0,27,27,0,0
7030125103,5,28,0,0,33,33,0,0
7030125104,2,47,0,0,42,49,25,4
7030125105,48,0,0,0,47,48,40,1
7030125106,58,0,0,0,55,58,0,0
7030125201,2,18,0,0,20,20,0,0
7030125202,30,1,0,0,30,31,0,0
7030125203,1,46,0,0,47,47,7,1
7030125301,38,11,0,0,49,49,0,0
7030125401,2,64,0,0,66,66,20,4
7030125402,47,1,0,0,45,48,132,13
7030125403,17,4,0,0,21,21,3,1
7030125404,19,0,0,0,17,19,0,0
7030125405,18,1,0,0,19,19,0,0
7030125406,7,0,0,0,7,7,0,0
7030125501,3,41,0,0,44,44,720,24
7030125502,26,0,0,0,26,26,0,0
7030125503,40,0,0,0,40,40,0,0
7030125504,1,48,0,0,47,49,0,0
7030125601,42,0,0,0,40,42,0,0
7030125602,48,0,0,0,48,48,1209,26
7030125603,14,15,0,0,28,29,220,22
7030125604,7,63,0,0,69,70,1877,61
7030125605,3,96,0,0,92,99,0,0
7030125606,2,94,0,0,96,96,0,0
7030125607,7,87,0,0,91,94,30,3
7030125608,80,1,0,0,80,81,150,2
7030125609,50,0,0,0,50,50,60,1
7030125610,99,2,0,0,94,101,0,0
7030125611,77,0,0,0,76,77,303,16
7030125801,1,37,0,0,38,38,0,0
7030125802,35,0,0,0,35,35,129,34
7030125901,1,19,0,0,20,20,21,7
7030125902,22,0,0,0,22,22,0,0
7030125903,5,6,0,0,11,11,0,0
7030126001,1,31,0,0,32,32,42,3
7030126002,0,64,0,0,64,64,0,0
7030126003,43,0,0,0,43,43,0,0
7030126004,29,0,0,0,29,29,72,3
7030126201,9,28,0,0,37,37,4,1
7030126202,6,89,0,0,92,95,0,0
7030126203,2,86,0,0,87,88,0,0
7030126204,36,6,0,0,42,42,0,0
7030126205,72,0,0,0,71,72,0,0
7030126206,74,0,0,0,74,74,0,0
7030126208,58,0,0,0,58,58,904,40
7030126301,6,15,0,0,21,21,80,2
7030126302,44,1,0,0,41,45,0,0
7030126303,2,58,0,0,59,60,0,0
7030126304,22,0,0,0,22,22,40,1
7030126401,85,0,0,0,85,85,0,0
7030126402,10,21,0,0,31,31,0,0
7030126403,35,0,0,0,35,35,0,0
7030126404,6,7,0,0,13,13,3,1
7030126405,20,1,0,0,21,21,0,0
7030126406,29,0,0,0,29,29,25,1
7030126801,3,30,0,0,33,33,0,0
7030126802,37,0,0,0,37,37,0,0
7030126901,1,53,0,0,53,54,0,0
7030126902,6,42,0,0,47,48,0,0
7030126903,49,0,0,0,49,49,0,0
7030126904,58,1,0,0,55,59,0,0
7030127001,77,0,0,0,77,77,63,14
7030127002,7,34,0,0,40,41,280,1
7030127003,5,56,0,0,61,61,0,0
7030127004,85,0,0,0,83,85,210,1
7030127101,41,0,0,0,41,41,7,1
7030127102,9,36,0,0,41,45,0,0
7030127103,10,11,0,0,20,21,0,0
7030127104,17,1,0,0,18,18,5,1
7030127201,42,1,0,0,43,43,296,18
7030127202,5,91,0,0,94,96,0,0
7030127203,9,0,0,0,9,9,0,0
7030224501,1,7,0,0,7,8,0,0
7030224701,18,8,0,0,25,26,0,0
7030224702,4,25,0,0,29,29,0,0
7030225001,28,11,0,0,39,39,79,11
7030225101,4,9,0,0,13,13,0,0
7030225401,14,16,0,0,30,30,0,0
7030226001,1,54,0,0,55,55,0,0
7030226501,20,15,0,0,35,35,0,0
7030323701,0,13,0,1,13,13,0,0
7030323702,2,7,0,1,8,9,0,0
7030323703,3,6,0,1,9,9,0,0
7030323704,1,7,0,1,7,8,0,0
7030323705,3,20,0,0,23,23,232,7
7030323706,0,12,0,0,12,12,0,0
7030324001,0,31,0,0,31,31,0,0
7030324002,0,14,0,1,14,14,215,1
7030324003,4,8,0,1,12,12,0,0
7030324004,2,38,0,0,40,40,0,0
7030324101,1,33,0,0,24,34,0,0
7030324102,0,13,0,1,13,13,0,0
7030324103,1,19,0,0,20,20,0,0
7030324104,1,8,0,1,9,9,0,0
7030324105,1,30,0,1,31,31,0,0
7030324106,6,56,0,0,62,62,0,0
7030324107,3,51,0,0,54,54,0,0
7030324108,3,9,0,0,12,12,0,0
7030324109,0,9,0,1,9,9,0,0
7030324110,3,32,0,0,35,35,0,0
7030324111,12,33,0,0,45,45,0,0
7030324112,25,110,0,2,133,135,695,135
7030324501,1,9,0,1,9,10,0,0
7030324502,1,7,0,0,7,8,0,0
7030324503,2,18,0,1,19,20,0,0
7030324504,4,12,0,0,16,16,0,0
7030324505,1,7,0,1,6,8,0,0
7030324506,1,27,0,1,28,28,0,0
7030324507,5,29,0,0,34,34,0,0
7030324508,0,8,0,1,7,8,0,0
7030324509,1,11,0,1,12,12,0,0
7030324601,2,36,0,0,38,38,280,1
7030324602,5,28,0,0,32,33,0,0
7030324603,0,11,0,1,10,11,0,0
7030324604,3,10,0,1,13,13,0,0
7030324605,8,22,0,0,30,30,0,0
7030324701,0,6,0,0,6,6,0,0
7030324702,0,18,0,1,16,18,0,0
7030324703,2,7,0,1,7,9,0,0
7030324704,0,17,0,1,16,17,0,0
7030324802,4,16,0,0,20,20,0,0
7030324803,5,20,0,0,25,25,0,0
7030324804,1,15,0,0,16,16,0,0
7030324805,11,83,0,0,94,94,2548,91
7030324901,1,7,0,1,8,8,0,0
7030325001,8,11,0,0,18,19,25,1
7030325002,12,7,0,1,18,19,50,1
7030325101,3,17,0,0,20,20,0,0
7030325102,2,10,0,1,12,12,0,0
7030325103,2,9,0,1,11,11,40,7
7030325201,2,8,0,1,10,10,0,0
7030325202,1,7,0,1,8,8,0,0
7030325203,4,5,0,1,7,9,0,0
7030325204,4,12,0,0,15,16,0,0
7030325205,0,17,0,1,16,17,0,0
7030325206,1,28,0,1,27,29,0,0
7030325207,1,47,0,0,48,48,0,0
7030325208,3,6,0,1,9,9,0,0
7030325209,2,8,0,1,9,10,42,5
7030325210,1,22,0,1,17,23,0,0
7030325211,2,9,0,1,11,11,0,0
7030325212,1,11,0,1,12,12,0,0
7030325301,1,22,0,1,23,23,0,0
7030325302,1,16,0,1,17,17,0,0
7030325303,0,17,0,0,17,17,0,0
7030325304,1,8,0,1,9,9,0,0
7030325305,3,23,0,0,26,26,0,0
7030325306,1,12,0,0,13,13,0,0
7030325307,1,9,0,1,10,10,0,0
7030325308,3,21,0,0,19,24,0,0
7030325402,2,14,0,1,16,16,0,0
7030325403,1,10,0,1,10,11,0,0
7030325404,3,7,0,1,9,10,0,0
7030325405,0,5,0,0,5,5,0,0
7030325406,2,16,0,0,16,18,0,0
7030325407,6,4,0,1,10,10,0,0
7030325408,2,8,0,1,8,10,0,0
7030325409,3,9,0,0,12,12,0,0
7030325410,3,9,0,1,10,12,0,0
7030325411,1,9,0,1,10,10,0,0
7030325412,3,29,0,0,26,32,0,0
7030325413,0,11,0,1,6,11,0,0
7030325501,5,6,0,1,10,11,0,0
7030325502,1,8,0,1,8,9,0,0
7030325503,1,11,0,1,11,12,94,11
7030325504,3,11,0,0,14,14,0,0
7030325505,2,7,0,1,9,9,0,0
7030325506,4,5,0,1,9,9,0,0
7030325507,2,7,0,1,9,9,0,0
7030325601,1,8,0,1,8,9,0,0
7030325602,8,5,0,1,12,13,2,1
7030325603,3,4,0,1,7,7,0,0
7030325604,3,6,0,1,9,9,0,0
7030325605,2,14,0,1,16,16,0,0
7030325606,0,8,0,1,8,8,0,0
7030325607,3,45,0,0,46,48,0,0
7030325608,1,33,0,1,34,34,230,34
7030325609,1,32,0,0,33,33,0,0
7030325610,0,9,0,1,8,9,0,0
7030325611,2,9,0,1,10,11,0,0
7030325612,2,7,0,1,9,9,0,0
7030325613,0,9,0,1,7,9,0,0
7030325614,1,8,0,1,9,9,0,0
7030325701,3,10,0,0,13,13,0,0
7030325702,1,7,0,1,8,8,0,0
7030325703,0,13,0,1,12,13,0,0
7030325801,11,21,0,0,32,32,0,0
7030325802,3,5,0,1,8,8,0,0
7030325901,0,17,0,1,17,17,0,0
7030325902,1,14,0,0,15,15,0,0
7030325903,1,8,0,1,9,9,0,0
7030325904,0,8,0,1,8,8,0,0
7030326001,1,8,0,1,9,9,0,0
7030326003,0,13,0,1,13,13,0,0
7030326004,0,8,0,1,7,8,0,0
7030326005,1,10,0,1,11,11,0,0
7030326006,0,9,0,1,9,9,0,0
7030326007,0,8,0,1,8,8,0,0
7030326008,15,121,0,1,131,136,0,0
7030326009,1,7,0,0,8,8,36,8
7030326010,2,6,0,1,8,8,0,0
7030326011,0,9,0,1,8,9,0,0
7030326012,4,5,0,1,9,9,0,0
7030326013,1,15,0,1,16,16,0,0
7030326014,1,9,0,0,10,10,0,0
7030326101,5,5,0,1,10,10,55,5
7030326102,0,20,0,0,20,20,134,20
7030326103,9,2,0,1,9,11,0,0
7030326104,2,9,0,0,11,11,0,0
7030326105,4,11,0,1,14,15,0,0
7030326106,2,5,0,1,6,7,0,0
7030326107,1,7,0,0,8,8,0,0
7030326201,1,16,0,1,16,17,0,0
7030326202,1,23,0,0,24,24,0,0
7030326203,3,4,0,1,5,7,0,0
7030326301,1,8,0,1,8,9,0,0
7030326302,1,9,0,1,10,10,0,0
7030326303,4,13,0,1,16,17,0,0
7030326304,2,8,0,1,7,10,0,0
7030326401,2,11,0,1,13,13,493,13
7030326402,5,6,0,1,10,11,0,0
7030326403,5,22,0,0,27,27,0,0
7030326404,12,31,0,0,43,43,0,0
7030326405,5,7,0,1,12,12,0,0
7030326406,1,11,0,1,12,12,0,0
7030326407,1,15,0,0,16,16,0,0
7030326408,8,13,0,0,17,21,0,0
7030326409,1,7,0,1,8,8,0,0
7030326410,2,9,0,1,11,11,40,1
7030326501,1,8,0,1,9,9,0,0
7030326502,2,8,0,1,8,10,0,0
7030326503,2,8,0,1,10,10,0,0
7030326505,2,7,0,1,7,9,0,0
7030326507,0,8,0,0,7,8,0,0
7030326508,3,14,0,0,16,17,0,0
7030326509,4,6,0,1,10,10,0,0
7030326510,1,8,0,1,9,9,0,0
7030326511,5,7,0,1,12,12,0,0
7030326512,5,5,0,1,8,10,0,0
7030326513,1,9,0,1,9,10,25,1
7030326514,2,7,0,1,9,9,0,0
7030326601,1,9,0,1,9,10,0,0
7030326602,1,14,0,0,15,15,0,0
7030326603,3,5,0,0,8,8,0,0
7030326604,4,5,0,1,9,9,0,0
7030326605,0,8,0,1,8,8,0,0
7030326606,1,9,0,1,10,10,0,0
7030326607,4,6,0,1,9,10,0,0
7030326608,5,4,0,1,9,9,0,0
7030326609,3,5,0,1,8,8,0,0
7030326610,5,6,0,1,10,11,0,0
7030326611,3,8,0,0,10,11,0,0
7030326612,3,6,0,0,9,9,0,0
7030326613,2,7,0,1,9,9,0,0
7030326614,1,8,0,1,9,9,0,0
7030326615,2,8,0,1,8,10,0,0
7030326616,3,8,0,0,11,11,0,0
7030326617,4,8,0,0,10,12,0,0
7030326618,5,5,0,1,2,10,0,0
7030326619,5,5,0,1,10,10,2,1
7030326620,4,14,0,0,17,18,0,0
7030326621,0,9,0,1,9,9,0,0
7030326622,3,10,0,1,11,13,0,0
7030326701,3,5,0,1,8,8,0,0
7030326702,1,8,0,1,9,9,0,0
7030326703,6,12,0,0,18,18,0,0
7030326704,1,7,0,1,7,8,0,0
7030326705,3,14,0,1,13,17,25,1
7030326706,7,13,0,0,20,20,200,20
7030326707,4,6,0,1,10,10,0,0
7030326801,0,26,0,0,26,26,0,0
7030326802,10,25,0,0,35,35,0,0
7030326803,4,9,0,0,13,13,0,0
7030326804,3,7,0,1,10,10,0,0
7030326805,1,9,0,1,10,10,0,0
7030326806,5,7,0,1,11,12,0,0
7030326807,2,11,0,0,13,13,0,0
7030326808,3,6,0,1,7,9,0,0
7030326809,1,13,0,1,14,14,0,0
7030326810,5,4,0,1,9,9,0,0
7030326811,0,12,0,1,12,12,0,0
7030326812,1,8,0,1,7,9,0,0
7030326813,3,6,0,1,8,9,0,0
7030326901,1,8,0,1,9,9,0,0
7030326903,2,8,0,1,10,10,0,0
7030327001,2,9,0,0,11,11,0,0
7030327002,17,43,0,0,54,60,18,6
7030327003,1,13,0,1,14,14,10,1
7030327004,3,12,0,1,15,15,0,0
7030327101,16,33,0,0,47,49,0,0
7030327102,9,7,0,0,15,16,0,0
7030327103,5,4,0,1,9,9,0,0
7030327104,2,7,0,1,7,9,0,0
7030327105,6,19,0,0,24,25,0,0
7030327106,5,12,0,0,14,17,0,0
7030327107,5,4,0,1,9,9,90,9
7030327108,4,5,0,1,9,9,0,0
7030327109,4,5,0,1,8,9,0,0
7030327111,10,16,0,0,23,26,0,0
7030327112,16,11,0,0,26,27,260,26
7030327113,1,7,0,1,7,8,0,0
7030327114,0,10,0,1,10,10,0,0
7030327201,0,12,0,1,10,12,0,0
7030327202,1,9,0,1,10,10,0,0
7030327203,0,9,0,1,9,9,0,0
7030327204,1,9,0,1,10,10,0,0
7030327205,4,8,0,1,12,12,0,0
7030327206,4,6,0,1,10,10,0,0
7030327207,3,11,0,0,13,14,0,0
7030424001,23,1,0,1,22,24,10,1
7030424002,5,32,0,1,28,37,50,5
7030424003,10,10,0,1,15,20,0,0
7030424004,0,25,0,1,19,25,258,20
7030424005,20,22,0,1,20,42,0,0
7030424006,2,35,0,1,29,37,4,4
7030424007,1,15,0,1,10,16,0,0
7030424101,9,5,0,0,13,14,0,0
7030424102,10,14,0,1,16,24,0,0
7030424103,0,18,0,1,18,18,0,0
7030424104,0,12,0,1,12,12,0,0
7030424105,0,11,0,1,10,11,0,0
7030424106,5,6,0,0,9,11,0,0
7030424107,9,5,0,0,13,14,10,1
7030424108,6,2,0,1,6,8,85,3
7030424109,9,0,0,1,9,9,0,0
7030424110,0,10,0,1,10,10,0,0
7030424111,1,25,0,1,22,26,0,0
7030424201,19,5,0,1,16,24,0,0
7030424202,6,2,0,1,3,8,5,1
7030424301,4,2,0,1,6,6,15,3
7030424302,1,32,0,1,25,33,0,0
7030424303,0,13,0,1,11,13,0,0
7030424304,7,3,0,1,9,10,0,0
7030424305,8,5,0,1,1,13,27,9
7030424306,1,21,0,1,22,22,0,0
7030424307,7,2,0,1,6,9,0,0
7030424308,0,11,0,1,10,11,0,0
7030424309,8,3,0,1,11,11,0,0
7030424310,1,11,0,1,11,12,0,0
7030424311,5,1,0,1,5,6,0,0
7030424312,0,6,0,1,6,6,0,0
7030424313,0,11,0,1,11,11,35,1
7030424314,6,2,0,1,6,8,0,0
7030424315,0,7,0,1,5,7,0,0
7030424316,3,5,0,1,8,8,0,0
7030424317,12,8,0,1,18,20,0,0
7030424318,1,13,0,1,13,14,0,0
7030424401,7,4,0,1,6,11,55,2
7030424402,7,5,0,1,9,12,0,0
7030424403,8,0,0,1,5,8,0,0
7030424404,11,2,0,1,8,13,0,0
7030424405,1,11,0,0,6,12,31,6
7030424406,11,7,0,1,16,18,0,0
7030424407,4,19,0,1,17,23,0,0
7030424408,0,16,0,0,9,16,0,0
7030424409,9,4,0,1,13,13,0,0
7030424410,0,19,0,1,19,19,0,0
7030424501,2,3,0,1,5,5,0,0
7030424502,5,0,0,1,4,5,0,0
7030424503,0,5,0,1,4,5,0,0
7030424504,4,1,0,1,5,5,0,0
7030424505,1,5,0,1,5,6,0,0
7030424506,0,7,0,1,5,7,15,2
7030424507,5,5,0,1,3,10,8,1
7030424508,0,11,0,1,10,11,0,0
7030424601,7,0,0,0,7,7,0,0
7030424602,3,21,0,1,21,24,0,0
7030424603,7,3,0,1,10,10,0,0
7030424604,0,12,0,1,11,12,0,0
7030424701,5,6,0,1,8,11,1,1
7030424702,3,2,0,1,4,5,0,0
7030424703,0,5,0,1,4,5,0,0
7030424704,8,3,0,1,8,11,0,0
7030424705,0,10,0,1,8,10,0,0
7030424706,4,7,0,1,10,11,0,0
7030424708,3,8,0,1,6,11,0,0
7030424709,0,5,0,1,5,5,90,3
7030424710,3,2,0,1,5,5,0,0
7030424711,0,5,0,1,5,5,0,0
7030424801,2,7,0,1,9,9,0,0
7030424803,0,8,0,1,8,8,0,0
7030424804,2,9,0,1,10,11,0,0
7030424805,11,6,0,1,13,17,216,1
7030424806,1,15,0,1,14,16,0,0
7030424807,10,0,0,1,9,10,0,0
7030424808,0,13,0,1,11,13,84,12
7030424809,3,9,0,1,11,12,0,0
7030424901,2,4,0,1,4,6,6,1
7030424902,14,4,0,1,12,18,0,0
7030424903,5,15,0,1,19,20,0,0
7030424904,11,3,0,1,13,14,0,0
7030425001,7,0,0,1,6,7,0,0
7030425002,2,15,0,1,13,17,0,0
7030425003,5,3,0,1,7,8,0,0
7030425004,8,1,0,1,7,9,0,0
7030425005,11,0,0,1,9,11,0,0
7030425006,10,5,0,1,9,15,0,0
7030425007,0,14,0,0,11,14,0,0
7030425101,8,8,0,1,15,16,2,1
7030425102,1,19,0,1,18,20,75,5
7030425103,4,11,0,1,8,15,32,1
7030425104,8,3,0,1,7,11,0,0
7030425105,4,8,0,1,8,12,0,0
7030425106,2,14,0,1,15,16,0,0
7030425107,8,18,0,1,14,26,0,0
7030425108,11,4,0,1,14,15,0,0
7030425201,6,5,0,1,5,11,0,0
7030425202,1,15,0,1,15,16,0,0
7030425203,9,5,0,1,7,14,36,6
7030425204,1,10,0,1,11,11,218,2
7030425301,2,3,0,1,4,5,0,0
7030425302,3,7,0,1,10,10,0,0
7030425303,1,27,0,1,20,28,15,1
7030425304,0,10,0,1,8,10,0,0
7030425305,5,4,0,1,9,9,0,0
7030425306,0,10,0,1,9,10,54,6
7030425307,13,15,0,1,16,28,0,0
7030425401,13,8,0,0,19,21,33,6
7030425402,5,16,0,1,10,21,0,0
7030425403,13,1,0,1,10,14,0,0
7030425404,7,9,0,1,11,16,0,0
7030425405,19,0,0,1,9,19,0,0
7030425406,0,29,0,1,28,29,3,1
7030425407,20,5,0,1,12,25,0,0
7030425408,7,23,0,1,18,30,0,0
7030425409,3,13,0,1,12,16,7,3
7030425501,13,9,0,1,17,22,0,0
7030425502,9,5,0,1,8,14,0,0
7030425503,2,11,0,1,11,13,0,0
7030425504,2,26,0,1,27,28,0,0
7030425601,7,8,0,1,14,15,0,0
7030425602,0,17,0,1,15,17,0,0
7030425603,9,2,0,1,10,11,0,0
7030425604,1,13,0,1,14,14,0,0
7030425605,15,2,0,1,11,17,2,1
7030425606,0,23,0,1,21,23,0,0
7030425607,3,13,0,1,16,16,0,0
7030425608,8,3,0,1,7,11,0,0
7030425609,0,11,0,1,10,11,0,0
7030425610,7,2,0,1,9,9,0,0
7030425611,2,10,0,1,12,12,0,0
7030425612,4,4,0,1,6,8,60,5
7030425701,9,6,0,1,7,15,0,0
7030425702,3,15,0,1,17,18,0,0
7030425703,1,11,0,1,12,12,280,8
7030425801,12,3,0,1,7,15,31,1
7030425802,0,13,0,1,11,13,0,0
7030425803,9,11,0,1,19,20,0,0
7030425804,2,19,0,1,18,21,0,0
7030425901,10,1,0,1,3,11,0,0
7030425902,3,6,0,1,5,9,0,0
7030425903,9,8,0,1,10,17,0,0
7030425904,1,16,0,1,11,17,0,0
7030426002,10,2,0,1,11,12,0,0
7030426003,0,17,0,1,14,17,1,1
7030426004,2,9,0,1,11,11,0,0
7030426005,0,5,0,1,5,5,0,0
7030426006,4,4,0,1,7,8,0,0
7030426007,0,12,0,1,11,12,77,11
7030426101,14,3,0,1,9,17,10,1
7030426102,4,17,0,1,7,21,0,0
7030426103,41,3,0,1,28,44,0,0
7030426104,8,31,0,1,31,39,0,0
7030426105,0,16,0,1,14,16,0,0
7030426201,12,8,0,1,12,20,172,12
7030426202,19,1,0,1,16,20,0,0
7030426205,1,26,0,1,22,27,0,0
7030426206,11,1,0,1,7,12,0,0
7030426207,9,3,0,1,6,12,0,0
7030426208,0,12,0,1,8,12,75,7
7030426209,2,9,0,1,10,11,0,0
7030426301,8,4,0,1,9,12,5,1
7030426302,0,11,0,1,8,11,0,0
7030426303,19,3,0,0,12,22,0,0
7030426401,5,26,0,1,25,31,0,0
7030426402,12,2,0,1,13,14,25,1
7030426403,2,17,0,1,1,19,0,0
7030426404,17,9,0,1,13,26,0,0
7030426405,4,28,0,1,21,32,0,0
7030426406,16,3,0,1,10,19,0,0
7030426407,11,6,0,1,14,17,0,0
7030426501,19,0,0,1,13,19,1,1
7030426502,14,3,0,1,14,17,0,0
7030426601,14,1,0,1,8,15,0,0
7030426602,9,13,0,1,21,22,0,0
7030426603,6,20,0,1,18,26,0,0
7030426801,7,20,0,1,9,27,0,0
7030426802,18,0,0,1,12,18,0,0
7030426803,18,41,0,0,29,59,0,0
7030426804,14,2,0,1,7,16,1,1
7030426901,10,2,0,1,6,12,0,0
7030426902,4,14,0,1,12,18,0,0
7030427001,19,4,0,1,9,23,115,18
7030427002,11,10,0,1,9,21,0,0
7030427003,6,6,0,1,9,12,15,1
7030427004,8,5,0,1,5,13,0,0
7030427005,7,12,0,1,7,19,0,0
7030427101,21,0,0,1,14,21,0,0
7030427102,21,10,0,1,10,31,0,0
7030427103,16,0,0,1,11,16,0,0
7030427104,12,0,0,1,12,12,0,0
7030427105,11,11,0,1,9,22,0,0
7030427106,7,22,0,1,11,29,0,0
7030427201,29,0,0,1,22,29,0,0
7030427202,26,1,0,1,15,27,0,0
7030427203,17,16,0,1,33,33,80,8
7030524801,0,7,0,1,7,7,0,0
7030623701,0,6,0,1,6,6,0,0
7030624001,0,6,0,1,6,6,0,0
7030624002,2,5,0,1,7,7,56,7
7030624101,0,6,0,1,5,6,0,0
7030624102,0,10,0,1,10,10,0,0
7030624103,0,4,0,1,4,4,0,0
7030624301,0,5,0,1,5,5,0,0
7030624503,2,3,0,1,5,5,0,0
7030624504,1,4,0,1,5,5,0,0
7030624505,0,5,0,1,5,5,0,0
7030624601,0,4,0,0,4,4,0,0
7030624602,0,5,0,0,5,5,0,0
7030624603,2,6,0,1,2,8,0,0
7030624604,0,5,0,1,5,5,0,0
7030624605,2,3,0,1,5,5,0,0
7030624606,1,4,0,1,5,5,0,0
7030624607,2,5,0,1,7,7,0,0
7030624608,1,4,0,1,2,5,0,0
7030624701,1,4,0,1,3,5,0,0
7030624702,0,6,0,1,3,6,96,6
7030624703,0,4,0,1,4,4,0,0
7030624704,0,5,0,1,5,5,0,0
7030624705,0,4,0,0,4,4,0,0
7030624706,0,7,0,1,6,7,121,7
7030624707,0,21,0,1,19,21,0,0
7030624801,0,6,0,1,6,6,0,0
7030624802,3,6,0,1,9,9,80,8
7030624803,0,6,0,1,6,6,0,0
7030624804,0,5,0,1,3,5,0,0
7030624805,1,9,0,1,10,10,0,0
7030624806,1,4,0,1,1,5,0,0
7030624901,0,5,0,1,5,5,0,0
7030624902,0,5,0,1,5,5,0,0
7030625001,6,1,0,1,7,7,0,0
7030625002,4,1,0,1,5,5,0,0
7030625003,2,4,0,1,6,6,0,0
7030625101,0,7,0,1,7,7,0,0
7030625102,0,5,0,1,2,5,0,0
7030625103,2,5,0,1,7,7,7,1
7030625104,0,5,0,1,5,5,0,0
7030625105,2,3,0,1,4,5,0,0
7030625106,0,5,0,1,4,5,0,0
7030625201,0,5,0,1,5,5,0,0
7030625202,0,5,0,1,5,5,0,0
7030625203,0,5,0,1,5,5,0,0
7030625204,0,6,0,1,6,6,0,0
7030625205,1,4,0,1,5,5,0,0
7030625206,0,6,0,1,6,6,0,0
7030625207,0,5,0,1,5,5,0,0
7030625208,1,4,0,1,5,5,2,1
7030625209,0,5,0,1,5,5,0,0
7030625210,0,5,0,1,5,5,0,0
7030625212,1,5,0,1,6,6,0,0
7030625214,0,5,0,1,5,5,0,0
7030625215,2,3,0,1,5,5,0,0
7030625216,0,5,0,1,5,5,0,0
7030625302,0,6,0,1,5,6,0,0
7030625303,0,5,0,1,3,5,0,0
7030625304,0,14,0,1,4,14,0,0
7030625305,0,5,0,1,3,5,0,0
7030625307,0,5,0,1,5,5,0,0
7030625308,2,3,0,1,4,5,0,0
7030625309,1,4,0,1,5,5,0,0
7030625401,0,5,0,1,5,5,0,0
7030625402,3,2,0,1,3,5,0,0
7030625403,0,5,0,1,5,5,0,0
7030625406,0,5,0,1,5,5,0,0
7030625407,1,4,0,1,5,5,0,0
7030625408,1,4,0,1,5,5,0,0
7030625409,0,5,0,1,5,5,0,0
7030625410,0,11,0,1,9,11,0,0
7030625411,1,4,0,1,5,5,0,0
7030625412,2,3,0,1,5,5,0,0
7030625413,2,3,0,1,5,5,678,3
7030625501,1,4,0,1,5,5,0,0
7030625502,0,5,0,1,2,5,0,0
7030625503,1,3,0,0,1,4,0,0
7030625504,1,4,0,1,5,5,0,0
7030625505,0,5,0,1,5,5,0,0
7030625601,1,4,0,1,0,5,0,0
7030625602,0,5,0,1,5,5,0,0
7030625604,0,5,0,1,5,5,0,0
7030625701,2,3,0,1,3,5,0,0
7030625702,4,4,0,1,7,8,0,0
7030625801,0,4,0,0,3,4,0,0
7030625802,1,4,0,1,5,5,0,0
7030625803,0,5,0,1,5,5,0,0
7030625804,0,5,0,1,5,5,0,0
7030625805,0,7,0,1,7,7,0,0
7030625901,0,6,0,1,5,6,0,0
7030625902,0,5,0,1,5,5,0,0
7030626002,0,5,0,1,5,5,0,0
7030626003,0,5,0,1,5,5,0,0
7030626004,0,8,0,1,4,8,0,0
7030626005,2,3,0,1,5,5,0,0
7030626006,0,5,0,1,5,5,0,0
7030626007,0,4,0,1,4,4,0,0
7030626008,1,4,0,1,5,5,0,0
7030626101,0,5,0,1,5,5,60,1
7030626102,2,3,0,1,1,5,0,0
7030626103,0,5,0,1,3,5,0,0
7030626104,1,4,0,1,3,5,0,0
7030626105,0,5,0,1,5,5,0,0
7030626106,1,4,0,1,5,5,0,0
7030626107,1,4,0,1,5,5,0,0
7030626108,2,9,0,1,6,11,0,0
7030626109,0,6,0,1,3,6,0,0
7030626110,2,3,0,1,5,5,0,0
7030626111,1,10,0,1,4,11,0,0
7030626301,2,3,0,1,0,5,0,0
7030626302,1,4,0,1,0,5,0,0
7030626303,0,5,0,1,5,5,0,0
7030626304,0,5,0,1,5,5,0,0
7030626305,0,5,0,1,5,5,0,0
7030626306,0,5,0,1,0,5,0,0
7030626307,1,4,0,1,1,5,0,0
7030626401,0,15,0,0,15,15,0,0
7030626402,1,5,0,1,5,6,0,0
7030626403,1,4,0,1,5,5,0,0
7030626404,1,5,0,1,5,6,0,0
7030626405,1,5,0,1,0,6,0,0
7030626406,0,5,0,1,2,5,0,0
7030626407,0,4,0,0,4,4,0,0
7030626408,1,6,0,1,3,7,0,0
7030626409,0,5,0,1,5,5,0,0
7030626410,0,5,0,1,4,5,0,0
7030626411,1,4,0,1,5,5,0,0
7030626412,2,3,0,1,2,5,0,0
7030626501,0,5,0,1,5,5,0,0
7030626503,0,5,0,1,5,5,0,0
7030626504,2,3,0,1,4,5,0,0
7030626601,2,3,0,1,4,5,0,0
7030626602,0,5,0,1,5,5,0,0
7030626603,2,3,0,1,2,5,0,0
7030626604,1,5,0,1,4,6,0,0
7030626605,0,5,0,1,3,5,0,0
7030626607,0,5,0,1,5,5,0,0
7030626609,0,5,0,1,5,5,0,0
7030626611,1,6,0,1,7,7,0,0
7030626612,0,5,0,1,5,5,0,0
7030626613,1,7,0,1,2,8,0,0
7030626614,0,5,0,1,5,5,0,0
7030626615,0,5,0,1,5,5,0,0
7030626616,2,4,0,1,0,6,0,0
7030626701,0,5,0,1,2,5,0,0
7030626702,0,5,0,1,5,5,0,0
7030626704,0,4,0,1,3,4,0,0
7030626705,5,10,0,1,8,15,0,0
7030626706,1,4,0,1,0,5,0,0
7030626707,2,5,0,1,0,7,0,0
7030626708,1,5,0,1,1,6,0,0
7030626709,2,6,0,1,5,8,0,0
7030626710,1,4,0,1,5,5,0,0
7030626711,2,3,0,1,5,5,0,0
7030626801,1,4,0,1,0,5,0,0
7030626802,1,4,0,1,4,5,0,0
7030626803,1,6,0,1,7,7,0,0
7030626804,2,3,0,1,4,5,0,0
7030626805,3,4,0,0,3,7,0,0
7030626901,0,5,0,1,5,5,0,0
7030626902,1,4,0,1,5,5,0,0
7030627001,0,5,0,1,0,5,0,0
7030627003,0,5,0,1,5,5,0,0
7030627004,4,1,0,1,5,5,0,0
7030627005,1,14,0,1,9,15,0,0
7030627006,0,5,0,1,5,5,0,0
7030627007,0,7,0,1,7,7,0,0
7030627008,0,5,0,1,4,5,0,0
7030627009,0,5,0,1,0,5,0,0
7030627010,4,4,0,1,8,8,0,0
7030627101,0,5,0,1,5,5,0,0
7030627103,0,5,0,1,5,5,0,0
7030627104,1,4,0,1,5,5,0,0
7030627105,1,5,0,1,2,6,0,0
7030627106,0,5,0,1,0,5,0,0
7030627107,2,4,0,1,2,6,0,0
7030627108,0,6,0,1,5,6,0,0
7030627201,0,5,0,1,4,5,0,0
7030627202,0,5,0,1,5,5,0,0
7030627203,3,2,0,1,1,5,0,0
7030627204,0,5,0,1,5,5,0,0
7030627205,0,6,0,1,6,6,0,0
7030627206,0,5,0,1,5,5,0,0
7030627207,0,5,0,1,3,5,0,0
7030627208,0,8,0,0,2,8,0,0
7030627209,0,5,0,1,5,5,0,0
7030627210,1,4,0,1,5,5,0,0
7030627211,1,4,0,1,5,5,0,0
7030627212,0,5,0,1,1,5,0,0
7030627213,0,5,0,1,0,5,0,0
7040120901,0,88,0,0,85,88,260,4
7040120902,59,0,0,0,59,59,0,0
7040120903,2,59,0,0,57,61,0,0
7040120904,46,0,0,0,46,46,38,8
7040121101,35,2,0,0,36,37,200,1
7040121102,62,2,0,0,53,64,0,0
7040121103,0,45,0,0,45,45,0,0
7040121104,0,75,0,0,72,75,0,0
7040121201,27,30,0,0,57,57,10164,56
7040121202,40,1,0,0,41,41,140,2
7040121203,1,66,0,0,65,67,0,0
7040121301,53,4,0,0,53,57,0,0
7040121302,1,28,0,0,28,29,100,1
7040121303,1,71,0,0,67,72,0,0
7040121304,25,0,0,0,25,25,60,1
7040121401,1,37,0,0,38,38,429,26
7040121402,1,74,0,0,74,75,119,29
7040121403,30,3,0,0,32,33,171,30
7040121404,38,7,0,0,45,45,36,1
7040121501,31,0,0,0,30,31,70,1
7040121502,53,0,0,0,52,53,163,41
7040121503,1,89,0,0,90,90,60,1
7040121504,0,75,0,0,71,75,0,0
7040121505,82,0,0,0,82,82,1070,54
7040121601,27,5,0,0,32,32,0,0
7040121602,1,34,0,0,35,35,0,0
7040121603,1,43,0,0,44,44,69,1
7040121701,49,3,0,0,48,52,0,0
7040121702,21,21,0,0,42,42,0,0
7040121703,1,86,0,0,87,87,0,0
7040121801,0,43,0,0,43,43,0,0
7040121802,0,63,0,0,60,63,40,8
7040121803,72,2,0,0,68,74,0,0
7040121901,28,0,0,0,28,28,60,1
7040121902,1,71,0,0,68,72,10,1
7040121903,19,9,0,0,28,28,567,22
7040121904,0,34,0,0,34,34,9,1
7040121905,0,69,0,0,65,69,162,10
7040121906,0,46,0,0,42,46,0,0
7040121907,33,0,0,0,33,33,0,0
7040121908,67,2,0,0,69,69,128,8
7040121909,58,1,0,0,59,59,94,47
7040121910,15,14,0,0,28,29,0,0
7040122001,1,35,0,0,36,36,2,1
7040122002,38,0,0,0,37,38,0,0
7040122003,2,56,0,0,53,58,175,1
7040122004,28,0,0,0,28,28,108,27
7040122005,47,2,0,0,47,49,0,0
7040122101,1,31,0,0,32,32,0,0
7040122102,23,6,0,0,29,29,68,17
7040122201,43,10,0,0,48,53,0,0
7040122202,1,72,0,0,69,73,0,0
7040122301,36,1,0,0,34,37,153,28
7040122302,54,2,0,0,56,56,0,0
7040122303,0,47,0,0,45,47,55,1
7040122304,1,65,0,0,66,66,12562,58
7040122401,30,3,0,0,33,33,843,21
7040122402,1,32,0,0,33,33,129,26
7040122502,5,43,0,0,48,48,10,1
7040122503,36,3,0,0,39,39,0,0
7040122504,1,41,0,0,42,42,0,0
7040122505,32,2,0,0,34,34,20,2
7040122601,42,3,0,0,44,45,0,0
7040122602,2,36,0,0,33,38,0,0
7040122603,2,45,0,0,46,47,0,0
7040122604,15,19,0,0,34,34,850,34
7040122605,26,0,0,0,26,26,0,0
7040122701,16,24,0,0,40,40,80,21
7040122702,2,50,0,0,46,52,0,0
7040122703,31,3,0,0,34,34,1589,7
7040122801,12,13,0,0,24,25,0,0
7040122901,15,10,0,0,25,25,180,18
7040122902,12,13,0,0,24,25,0,0
7040122903,0,63,0,0,60,63,164,41
7040122904,0,27,0,0,27,27,0,0
7040122905,0,29,0,0,28,29,0,0
7040122906,48,4,0,0,48,52,147,3
7040122907,32,5,0,0,34,37,99,34
7040122908,31,0,0,0,31,31,700,28
7040122909,36,1,0,0,36,37,5,2
7040122910,1,33,0,0,33,34,0,0
7040122911,1,59,0,0,49,60,0,0
7040123001,2,48,0,0,49,50,5,1
7040123002,2,59,0,0,55,61,0,0
7040123003,33,1,0,0,34,34,260,26
7040123004,42,4,0,0,38,46,121,3
7040123101,13,13,0,0,26,26,0,0
7040123102,0,59,0,0,59,59,270,8
7040123103,48,7,0,0,52,55,85,15
7040123104,0,47,0,0,46,47,303,18
7040123401,0,31,0,0,31,31,84,21
7040123402,29,0,0,0,25,29,0,0
7040123501,1,51,0,0,52,52,144,32
7040123502,17,11,0,0,28,28,0,0
7040123503,45,2,0,0,47,47,0,0
7040123601,19,19,0,0,28,38,440,2
7040123602,42,10,0,0,49,52,0,0
7040123701,8,10,0,0,18,18,0,0
7040123702,3,31,0,0,34,34,0,0
7040123703,1,27,0,0,28,28,0,0
7040123704,0,51,0,0,51,51,1,1
7040123705,35,2,0,0,37,37,0,0
7040123706,27,0,0,0,26,27,0,0
7040123707,45,2,0,0,41,47,0,0
7040123801,53,1,0,0,52,54,0,0
7040123802,0,36,0,0,36,36,0,0
7040123803,1,39,0,0,40,40,0,0
7040123804,21,2,0,0,23,23,0,0
7040123805,0,81,0,0,81,81,11,2
7040123806,53,9,0,0,62,62,0,0
7040221601,5,21,0,1,25,26,58,26
7040222801,0,15,0,1,10,15,66,1
7040222901,0,4,0,1,3,4,52,1
7040222902,2,30,0,0,32,32,0,0
7040223001,2,1,0,0,3,3,0,0
7040223201,7,1,0,1,7,8,0,0
7040223401,0,8,0,0,8,8,0,0
7040223402,2,47,0,0,47,49,0,0
7040223403,16,8,0,0,24,24,0,0
7040223404,19,17,0,0,36,36,0,0
7040223501,14,8,0,0,21,22,0,0
7040223601,17,11,0,0,28,28,76,26
7040223701,0,33,0,0,33,33,0,0
7040223702,16,9,0,1,22,25,266,1
7040223703,7,5,0,0,12,12,0,0
7040320902,0,22,0,1,22,22,0,0
7040320903,0,9,0,1,9,9,86,6
7040320904,0,9,0,1,9,9,0,0
7040320905,21,94,0,1,114,115,4728,115
7040321001,2,12,0,1,14,14,0,0
7040321201,2,12,0,1,14,14,0,0
7040321202,4,9,0,1,13,13,0,0
7040321203,0,12,0,1,12,12,0,0
7040321204,1,11,0,1,10,12,0,0
7040321401,12,104,0,1,115,116,0,0
7040321402,7,46,0,0,53,53,0,0
7040321403,3,18,0,0,21,21,0,0
7040321404,7,47,0,1,53,54,0,0
7040321405,2,23,0,0,25,25,0,0
7040321501,8,5,0,1,13,13,0,0
7040321502,10,5,0,1,15,15,0,0
7040321503,6,9,0,1,13,15,0,0
7040321504,1,44,0,0,45,45,1220,33
7040321505,1,14,0,0,15,15,0,0
7040321602,10,58,0,0,66,68,0,0
7040321603,4,65,0,1,68,69,0,0
7040321604,6,58,0,0,64,64,0,0
7040321605,1,19,0,1,20,20,0,0
7040321606,11,82,0,0,90,93,0,0
7040321607,1,25,0,1,26,26,0,0
7040321608,10,48,0,0,58,58,0,0
7040321609,3,20,0,0,22,23,10,1
7040321610,1,22,0,1,23,23,0,0
7040321701,1,10,0,1,11,11,0,0
7040321702,7,62,0,0,66,69,0,0
7040321703,1,11,0,1,12,12,0,0
7040321801,3,11,0,1,14,14,0,0
7040321802,4,4,0,1,7,8,0,0
7040321803,1,12,0,1,13,13,0,0
7040321804,0,8,0,1,8,8,0,0
7040321901,2,9,0,1,11,11,0,0
7040321902,1,11,0,1,12,12,0,0
7040321903,4,73,0,0,77,77,0,0
7040322001,1,20,0,1,20,21,140,20
7040322002,4,15,0,1,18,19,410,18
7040322003,3,67,0,0,69,70,0,0
7040322004,3,25,0,0,28,28,0,0
7040322005,2,51,0,0,53,53,0,0
7040322006,0,16,0,1,16,16,0,0
7040322007,12,113,0,2,124,125,4943,125
7040322008,10,109,0,0,118,119,0,0
7040322009,11,63,0,0,74,74,0,0
7040322101,2,9,0,1,10,11,0,0
7040322102,0,11,0,1,11,11,0,0
7040322201,0,8,0,1,6,8,0,0
7040322202,0,19,0,0,19,19,0,0
7040322203,2,10,0,1,11,12,0,0
7040322204,7,69,0,0,76,76,0,0
7040322301,3,11,0,0,14,14,0,0
7040322302,2,9,0,1,11,11,0,0
7040322303,1,8,0,1,9,9,0,0
7040322401,3,6,0,1,6,9,0,0
7040322402,2,21,0,0,23,23,0,0
7040322403,0,23,0,1,23,23,0,0
7040322501,0,32,0,0,31,32,0,0
7040322502,4,40,0,0,44,44,348,44
7040322503,19,110,0,1,125,129,0,0
7040322504,15,119,0,0,134,134,0,0
7040322505,2,40,0,0,40,42,0,0
7040322506,0,9,0,1,9,9,0,0
7040322507,4,54,0,1,54,58,0,0
7040322508,1,27,0,0,27,28,0,0
7040322509,5,63,0,0,67,68,0,0
7040322510,8,25,0,1,31,33,0,0
7040322601,9,24,0,1,30,33,0,0
7040322602,0,8,0,1,8,8,21,3
7040322603,11,68,0,0,76,79,0,0
7040322604,6,53,0,1,54,59,2160,59
7040322605,27,66,0,0,38,93,0,0
7040322701,2,27,0,0,29,29,0,0
7040322702,5,35,0,0,40,40,0,0
7040322703,14,55,0,0,69,69,0,0
7040322704,2,32,0,0,34,34,0,0
7040322705,2,8,0,1,10,10,0,0
7040322706,7,76,0,0,81,83,0,0
7040322707,5,20,0,0,23,25,0,0
7040322801,2,9,0,1,11,11,0,0
7040322802,4,32,0,0,35,36,612,34
7040322803,0,12,0,1,12,12,0,0
7040322804,0,74,0,1,74,74,0,0
7040322805,5,31,0,0,36,36,702,36
7040322806,2,65,0,0,67,67,0,0
7040322807,6,75,0,0,80,81,0,0
7040322809,6,50,0,1,55,56,0,0
7040322810,4,88,0,0,92,92,0,0
7040322811,0,56,0,1,56,56,560,56
7040322812,13,135,0,0,148,148,0,0
7040322901,0,52,0,0,52,52,0,0
7040322902,0,10,0,1,10,10,35,1
7040322903,2,15,0,1,17,17,0,0
7040322904,1,12,0,0,10,13,0,0
7040322906,3,8,0,0,11,11,0,0
7040322907,1,18,0,1,19,19,0,0
7040322908,4,13,0,0,15,17,108,13
7040322909,2,28,0,0,30,30,77,28
7040322910,1,78,0,0,78,79,0,0
7040323001,2,11,0,1,13,13,0,0
7040323002,0,8,0,1,8,8,0,0
7040323003,0,12,0,1,12,12,0,0
7040323101,0,16,0,1,16,16,0,0
7040323102,1,11,0,1,12,12,0,0
7040323103,0,9,0,1,8,9,37,9
7040323104,5,14,0,0,19,19,0,0
7040323105,2,81,0,0,81,83,273,79
7040323201,2,11,0,1,13,13,0,0
7040323202,1,8,0,1,9,9,0,0
7040323203,0,10,0,1,10,10,0,0
7040323204,6,58,0,0,64,64,0,0
7040323401,0,9,0,1,9,9,63,1
7040323402,0,19,0,0,19,19,54,18
7040323403,0,13,0,1,13,13,6,1
7040323501,1,8,0,1,9,9,0,0
7040323503,1,10,0,1,11,11,0,0
7040323602,4,3,0,0,7,7,42,5
7040323603,0,9,0,1,9,9,0,0
7040323604,10,33,0,0,43,43,60,1
7040323605,0,13,0,1,12,13,24,2
7040323801,0,2,0,0,2,2,0,0
7040323803,0,43,0,0,41,43,645,43
7040323804,0,19,0,0,19,19,521,19
7040323805,0,31,0,0,30,31,0,0
7040323806,0,9,0,1,9,9,125,5
7040323807,1,9,0,1,9,10,40,10
7040323808,0,9,0,1,9,9,0,0
7040323809,0,69,0,0,67,69,65,1
7040323810,4,65,0,0,69,69,0,0
7040323811,0,9,0,0,9,9,0,0
7040323901,0,7,0,0,7,7,0,0
7040323902,2,55,0,0,56,57,1061,56
7040323903,0,28,0,1,28,28,0,0
7040420901,1,10,0,1,6,11,30,5
7040420902,7,4,0,1,11,11,0,0
7040420903,0,8,0,1,6,8,68,3
7040420904,0,13,0,1,13,13,0,0
7040420905,5,3,0,1,4,8,0,0
7040421001,2,12,0,0,10,14,0,0
7040421002,6,4,0,1,10,10,0,0
7040421003,2,10,0,1,8,12,0,0
7040421004,4,1,0,1,1,5,0,0
7040421005,2,9,0,1,9,11,0,0
7040421006,7,0,0,1,6,7,90,3
7040421007,0,12,0,1,7,12,5,1
7040421008,3,2,0,1,5,5,0,0
7040421101,4,3,0,1,7,7,0,0
7040421102,4,6,0,0,10,10,0,0
7040421103,3,6,0,1,9,9,0,0
7040421104,13,0,0,0,9,13,315,7
7040421105,5,11,0,1,14,16,0,0
7040421106,6,0,0,0,4,6,0,0
7040421107,3,11,0,1,10,14,0,0
7040421108,0,8,0,1,6,8,0,0
7040421201,3,13,0,1,11,16,0,0
7040421202,16,3,0,1,19,19,0,0
7040421203,0,37,0,1,21,37,0,0
7040421204,6,5,0,1,2,11,0,0
7040421301,3,1,0,1,4,4,0,0
7040421302,0,6,0,1,4,6,0,0
7040421303,3,1,0,1,4,4,0,0
7040421304,0,5,0,1,5,5,0,0
7040421305,8,2,0,1,8,10,0,0
7040421306,0,12,0,1,9,12,0,0
7040421401,0,13,0,1,11,13,4,1
7040421402,0,20,0,1,14,20,0,0
7040421403,1,7,0,1,6,8,0,0
7040421404,5,0,0,1,5,5,0,0
7040421405,0,6,0,1,3,6,0,0
7040421406,5,1,0,1,4,6,0,0
7040421407,3,15,0,1,15,18,0,0
7040421408,7,4,0,1,3,11,0,0
7040421409,7,5,0,1,8,12,0,0
7040421501,12,6,0,1,12,18,10,1
7040421502,3,13,0,1,14,16,0,0
7040421503,0,21,0,1,18,21,49,7
7040421504,4,15,0,1,15,19,0,0
7040421601,2,4,0,1,5,6,0,0
7040421602,0,17,0,1,12,17,0,0
7040421603,9,4,0,1,10,13,3,1
7040421604,8,3,0,1,11,11,10,1
7040421605,0,19,0,1,19,19,0,0
7040421606,11,0,0,1,9,11,0,0
7040421607,2,19,0,1,19,21,0,0
7040421608,13,2,0,1,13,15,11,1
7040421609,9,12,0,1,14,21,0,0
7040421610,15,7,0,1,21,22,0,0
7040421611,0,24,0,1,20,24,0,0
7040421701,6,2,0,1,7,8,0,0
7040421702,0,14,0,1,14,14,0,0
7040421703,0,16,0,1,15,16,0,0
7040421704,3,12,0,1,13,15,0,0
7040421801,4,9,0,1,12,13,0,0
7040421802,2,9,0,0,8,11,0,0
7040421803,0,15,0,1,14,15,0,0
7040421804,7,2,0,0,3,9,0,0
7040421805,0,14,0,1,14,14,0,0
7040421806,11,3,0,1,14,14,0,0
7040421807,0,19,0,0,17,19,20,3
7040421901,1,2,0,1,3,3,0,0
7040421902,0,5,0,1,5,5,3,1
7040421903,3,3,0,1,4,6,14,2
7040421904,0,6,0,1,6,6,0,0
7040421905,8,3,0,1,11,11,0,0
7040421906,0,13,0,1,10,13,0,0
7040421907,4,1,0,1,4,5,0,0
7040421908,1,4,0,1,5,5,0,0
7040421909,3,2,0,1,4,5,58,4
7040421910,0,5,0,1,5,5,0,0
7040421911,5,0,0,1,5,5,32,2
7040421912,0,8,0,1,8,8,0,0
7040421913,3,3,0,1,6,6,0,0
7040422001,4,8,0,1,10,12,0,0
7040422002,0,17,0,1,13,17,0,0
7040422003,5,5,0,1,5,10,0,0
7040422004,1,14,0,1,11,15,0,0
7040422005,0,10,0,1,9,10,0,0
7040422006,5,6,0,1,11,11,40,1
7040422101,1,16,0,1,14,17,0,0
7040422102,3,5,0,1,5,8,0,0
7040422103,1,2,0,1,3,3,0,0
7040422104,0,5,0,1,4,5,0,0
7040422106,3,8,0,1,9,11,0,0
7040422202,2,11,0,1,12,13,87,8
7040422203,2,6,0,1,8,8,0,0
7040422204,1,10,0,1,11,11,0,0
7040422205,1,4,0,1,3,5,0,0
7040422206,0,5,0,1,4,5,0,0
7040422301,8,4,0,1,10,12,0,0
7040422302,0,13,0,1,13,13,0,0
7040422303,1,4,0,1,5,5,0,0
7040422304,0,4,0,1,4,4,0,0
7040422305,2,4,0,1,1,6,39,5
7040422306,0,6,0,1,6,6,0,0
7040422401,6,1,0,1,5,7,0,0
7040422402,4,4,0,1,7,8,0,0
7040422403,1,5,0,1,6,6,138,6
7040422404,0,11,0,1,9,11,0,0
7040422405,0,11,0,1,11,11,0,0
7040422406,0,8,0,1,8,8,145,7
7040422501,1,7,0,1,6,8,0,0
7040422502,1,4,0,1,5,5,1,1
7040422503,0,5,0,1,4,5,0,0
7040422601,1,7,0,1,3,8,0,0
7040422602,0,16,0,1,16,16,0,0
7040422603,6,8,0,1,11,14,0,0
7040422604,0,5,0,1,4,5,14,1
7040422605,5,12,0,1,15,17,10,2
7040422606,0,13,0,1,13,13,0,0
7040422607,5,6,0,1,9,11,0,0
7040422608,0,15,0,1,13,15,0,0
7040422609,2,3,0,1,3,5,0,0
7040422701,2,7,0,0,7,9,0,0
7040422702,0,12,0,1,12,12,17,5
7040422703,0,13,0,1,13,13,0,0
7040422704,4,4,0,1,7,8,0,0
7040422705,0,19,0,1,16,19,12,1
7040422802,4,7,0,1,8,11,0,0
7040422901,0,5,0,1,4,5,50,4
7040422902,1,5,0,1,5,6,0,0
7040422903,0,5,0,1,4,5,48,4
7040422904,3,8,0,1,11,11,0,0
7040422905,0,11,0,1,11,11,0,0
7040422906,0,12,0,1,8,12,0,0
7040422907,1,10,0,1,8,11,0,0
7040422909,0,5,0,1,4,5,0,0
7040422910,1,4,0,1,3,5,0,0
7040422911,1,9,0,1,5,10,0,0
7040423001,2,11,0,1,11,13,5,1
7040423002,5,7,0,1,10,12,15,1
7040423003,0,16,0,1,16,16,2,1
7040423004,3,5,0,0,6,8,15,3
7040423005,0,12,0,1,11,12,45,5
7040423101,0,6,0,1,5,6,0,0
7040423102,0,7,0,1,7,7,0,0
7040423103,2,3,0,1,0,5,0,0
7040423104,1,6,0,0,4,7,0,0
7040423105,0,11,0,1,10,11,0,0
7040423106,0,11,0,1,10,11,40,6
7040423201,2,9,0,1,7,11,45,4
7040423202,0,13,0,1,11,13,0,0
7040423204,0,5,0,1,4,5,0,0
7040423205,2,3,0,1,4,5,0,0
7040423206,0,5,0,1,5,5,29,5
7040423207,3,2,0,1,2,5,0,0
7040423301,4,7,0,1,5,11,0,0
7040423302,2,1,0,1,0,3,0,0
7040423303,0,10,0,1,8,10,25,1
7040423401,4,1,0,1,5,5,0,0
7040423402,2,2,0,1,4,4,0,0
7040423403,2,3,0,1,5,5,30,1
7040423404,2,6,0,1,8,8,24,1
7040423405,0,8,0,1,7,8,0,0
7040423406,0,8,0,1,7,8,0,0
7040423501,0,11,0,1,9,11,0,0
7040423502,5,5,0,1,9,10,0,0
7040423503,0,11,0,1,11,11,0,0
7040423504,2,3,0,1,3,5,0,0
7040423505,0,5,0,1,5,5,120,4
7040423506,21,10,0,1,19,31,0,0
7040423507,1,26,0,0,24,27,2147,20
7040423601,10,3,0,1,12,13,0,0
7040423602,0,18,0,1,16,18,0,0
7040423603,8,7,0,1,3,15,0,0
7040423606,0,13,0,1,9,13,0,0
7040423607,0,5,0,1,4,5,0,0
7040423608,2,2,0,1,1,4,0,0
7040423609,0,5,0,1,5,5,0,0
7040423610,1,3,0,1,4,4,120,2
7040423701,1,6,0,1,7,7,0,0
7040423702,0,8,0,1,8,8,10,1
7040423703,0,5,0,1,4,5,0,0
7040423704,3,2,0,1,2,5,0,0
7040423705,0,7,0,1,6,7,0,0
7040423801,0,5,0,1,5,5,60,5
7040423802,3,2,0,1,2,5,0,0
7040423803,1,6,0,1,7,7,10,2
7040423804,3,5,0,1,8,8,203,5
7040423805,0,6,0,1,4,6,0,0
7040423806,4,14,0,1,13,18,0,0
7040423901,0,23,0,1,23,23,60,3
7040423902,8,9,0,1,14,17,0,0
7040423903,0,18,0,1,18,18,136,17
7040522201,0,2,0,1,2,2,0,0
7040522901,0,8,0,1,8,8,0,0
7040523301,0,15,0,1,15,15,60,1
7040523401,0,2,0,1,2,2,5,1
7040523402,1,3,0,1,3,4,0,0
7040523501,2,8,0,0,7,10,0,0
7040523701,2,1,0,1,1,3,0,0
7040523702,0,8,0,0,7,8,0,0
7040523703,0,5,0,1,3,5,2,1
7040523704,0,4,0,1,4,4,0,0
7040620901,0,7,0,1,6,7,0,0
7040620902,0,15,0,1,15,15,0,0
7040621001,0,6,0,1,6,6,0,0
7040621002,1,14,0,1,14,15,0,0
7040621201,2,5,0,1,7,7,70,7
7040621202,0,6,0,1,6,6,0,0
7040621203,1,4,0,1,4,5,0,0
7040621204,1,4,0,1,5,5,0,0
7040621205,0,7,0,1,7,7,0,0
7040621206,0,5,0,1,5,5,0,0
7040621207,1,5,0,1,5,6,0,0
7040621208,1,4,0,1,5,5,0,0
7040621210,0,3,0,1,2,3,12,2
7040621401,0,5,0,1,4,5,0,0
7040621402,4,4,0,1,0,8,0,0
7040621501,1,5,0,1,4,6,0,0
7040621502,1,6,0,1,6,7,0,0
7040621503,0,5,0,1,5,5,3,1
7040621601,4,3,0,1,6,7,0,0
7040621602,0,10,0,1,10,10,150,10
7040621603,2,4,0,1,5,6,0,0
7040621604,1,8,0,1,8,9,0,0
7040621605,1,4,0,1,5,5,0,0
7040621606,1,8,0,1,9,9,0,0
7040621607,0,5,0,1,2,5,0,0
7040621608,4,2,0,1,6,6,0,0
7040621609,0,6,0,1,0,6,0,0
7040621610,0,6,0,1,6,6,0,0
7040621701,0,5,0,1,5,5,0,0
7040621702,0,6,0,1,1,6,0,0
7040621703,0,5,0,1,5,5,0,0
7040621801,0,6,0,1,4,6,0,0
7040621802,0,5,0,1,0,5,0,0
7040621803,0,5,0,1,5,5,5,1
7040621804,0,11,0,1,8,11,0,0
7040621805,0,5,0,1,3,5,0,0
7040621806,1,4,0,1,5,5,0,0
7040621807,0,5,0,1,3,5,0,0
7040621901,1,6,0,1,2,7,0,0
7040621902,0,7,0,1,5,7,0,0
7040621903,0,5,0,1,5,5,0,0
7040621904,2,6,0,1,8,8,0,0
7040621905,0,12,0,1,12,12,0,0
7040621906,0,5,0,1,5,5,0,0
7040621907,3,4,0,1,6,7,0,0
7040621908,0,7,0,1,7,7,0,0
7040622101,0,5,0,1,5,5,0,0
7040622102,1,4,0,1,5,5,0,0
7040622201,1,4,0,1,5,5,0,0
7040622202,0,7,0,1,7,7,0,0
7040622203,0,3,0,1,3,3,66,3
7040622204,0,6,0,1,6,6,150,6
7040622205,0,5,0,1,5,5,0,0
7040622206,0,5,0,1,5,5,0,0
7040622301,3,2,0,1,0,5,0,0
7040622302,0,10,0,1,10,10,0,0
7040622303,0,10,0,1,6,10,0,0
7040622304,0,5,0,1,5,5,0,0
7040622305,2,3,0,1,5,5,0,0
7040622306,2,4,0,1,5,6,0,0
7040622307,1,4,0,1,5,5,0,0
7040622308,0,5,0,1,5,5,0,0
7040622401,0,7,0,1,3,7,0,0
7040622402,0,6,0,1,5,6,0,0
7040622403,0,7,0,1,6,7,0,0
7040622501,0,5,0,1,5,5,0,0
7040622502,1,4,0,1,4,5,0,0
7040622601,0,9,0,0,9,9,70,9
7040622602,4,21,0,1,24,25,0,0
7040622702,1,4,0,1,4,5,0,0
7040622703,0,6,0,1,3,6,0,0
7040622705,1,4,0,1,5,5,0,0
7040622801,0,14,0,1,12,14,0,0
7040622901,1,16,0,1,16,17,0,0
7040622902,0,12,0,1,12,12,0,0
7040623001,1,4,0,1,5,5,0,0
7040623002,0,5,0,1,5,5,0,0
7040623003,0,5,0,1,5,5,0,0
7040623101,0,7,0,1,7,7,0,0
7040623102,0,5,0,1,5,5,0,0
7040623103,0,5,0,1,3,5,0,0
7040623201,0,5,0,1,3,5,0,0
7040623202,0,6,0,1,6,6,0,0
7040623203,1,4,0,1,4,5,0,0
7040623204,1,4,0,1,3,5,0,0
7040623205,1,5,0,1,1,6,0,0
7040623206,0,5,0,1,5,5,0,0
7040623207,0,14,0,1,11,14,0,0
7040623208,0,5,0,1,3,5,0,0
7040623209,0,5,0,1,5,5,0,0
7040623210,0,4,0,1,3,4,0,0
7040623211,0,5,0,1,3,5,0,0
7040623212,1,4,0,1,5,5,0,0
7040623301,2,8,0,1,10,10,51,9
7040623402,0,5,0,1,3,5,29,5
7040623403,0,5,0,1,3,5,0,0
7040623405,0,3,0,1,2,3,0,0
7040623407,1,3,0,1,4,4,0,0
7040623409,0,5,0,1,5,5,0,0
7040623410,0,4,0,1,4,4,0,0
7040623501,0,5,0,1,5,5,0,0
7040623502,0,5,0,1,5,5,0,0
7040623503,1,4,0,1,5,5,0,0
7040623504,0,6,0,1,6,6,0,0
7040623505,2,3,0,1,5,5,0,0
7040623506,0,10,0,1,9,10,0,0
7040623602,0,6,0,1,6,6,18,5
7040623603,2,3,0,1,5,5,0,0
7040623604,0,3,0,1,3,3,0,0
7040623605,0,10,0,1,9,10,140,10
7040623606,1,4,0,1,4,5,0,0
7040623607,2,3,0,1,1,5,0,0
7040623608,3,4,0,1,4,7,0,0
7040623703,0,6,0,1,6,6,0,0
7040623704,0,5,0,1,5,5,0,0
7040623705,0,5,0,1,5,5,0,0
7040623706,0,3,0,1,3,3,0,0
7040623707,0,4,0,0,4,4,0,0
7040623708,1,4,0,1,4,5,0,0
7040623709,1,9,0,1,8,10,0,0
7040623710,0,5,0,1,5,5,0,0
7040623801,0,4,0,0,4,4,0,0
7040623802,1,4,0,1,5,5,30,3
7040623803,1,6,0,1,7,7,0,0
7040623804,0,7,0,1,5,7,0,0
7040623805,2,13,0,1,14,15,540,15
7040623901,0,2,0,1,2,2,0,0
7040922503,31,105,0,2,129,136,0,0
7040922504,16,42,0,1,56,58,22,1
070501ND201,19,16,0,0,28,35,0,0
070501ND401,0,26,0,0,21,26,50,2
070501ND402,19,0,0,0,19,19,60,1
070501ND403,13,37,0,0,41,50,271,10
070501ND404,21,35,0,0,48,56,20,1
7050208101,0,5,0,0,5,5,64,5
070502ND101,1,27,0,0,28,28,18,9
070502ND102,1,3,0,0,4,4,0,0
070502ND103,10,29,0,0,39,39,0,0
070502ND104,1,41,0,0,40,42,0,0
070502ND105,6,29,0,0,33,35,368,4
070502ND106,15,26,0,0,38,41,0,0
070502ND107,4,26,0,0,30,30,0,0
070502ND201,2,3,0,0,5,5,0,0
070502ND202,10,35,0,1,44,45,1274,45
070502ND203,0,15,0,0,13,15,5,5
070502ND301,2,66,0,0,67,68,0,0
070502ND302,4,44,0,1,47,48,0,0
070502ND401,7,30,0,0,37,37,0,0
070502ND402,4,18,0,1,22,22,0,0
070502ND403,5,31,0,1,36,36,22,3
070502ND404,8,41,0,0,46,49,0,0
070502ND405,11,14,0,0,25,25,0,0
070502ND801,18,5,0,0,22,23,302,1
070502ND803,4,35,0,0,39,39,0,0
070503ND101,7,32,0,0,39,39,0,0
070503ND102,2,80,0,0,80,82,0,0
070503ND201,0,58,0,1,55,58,0,0
070503ND202,1,66,0,1,62,67,0,0
070503ND203,22,84,0,1,106,106,0,0
070503ND204,13,83,0,1,94,96,0,0
070503ND205,15,91,0,0,99,106,570,57
070503ND206,0,23,0,0,23,23,0,0
070503ND401,9,55,0,1,57,64,0,0
070503ND801,7,49,0,0,47,56,0,0
070503ND901,16,174,0,0,186,190,220,1
070503ND902,4,57,0,1,60,61,0,0
070503ND903,5,74,0,0,79,79,51,11
070507ND101,2,14,0,1,13,16,30,1
070507ND102,4,41,0,0,41,45,0,0
070507ND105,4,10,0,1,12,14,0,0
070507ND106,7,15,0,1,20,22,0,0
070507ND107,10,26,0,0,36,36,0,0
070507ND108,25,23,0,1,47,48,0,0
070507ND109,7,28,0,0,35,35,1251,32
070507ND110,12,44,0,1,54,56,0,0
070507ND111,3,8,0,1,10,11,0,0
070507ND201,3,13,0,1,15,16,0,0
070507ND202,1,9,0,1,9,10,0,0
070507ND203,5,29,0,1,30,34,0,0
070507ND205,1,6,0,1,7,7,0,0
070507ND206,6,3,0,1,9,9,225,5
070507ND301,3,12,0,1,15,15,0,0
070507ND302,10,12,0,1,21,22,0,0
070507ND303,1,11,0,1,12,12,0,0
070507ND304,4,7,0,1,11,11,0,0
070507ND307,21,19,0,1,38,40,405,2
070507ND402,3,5,0,1,8,8,0,0
070507ND403,13,16,0,1,23,29,0,0
070507ND406,14,27,0,0,41,41,190,18
070507ND408,1,7,0,1,8,8,0,0
070507ND410,14,44,0,1,55,58,0,0
070507ND411,19,28,0,1,45,47,14,2
070507ND413,6,13,0,0,16,19,0,0
070507ND504,4,1,0,1,4,5,156,2
070507ND505,4,7,0,1,10,11,0,0
070507ND508,4,4,0,1,7,8,0,0
070507ND601,11,34,0,0,45,45,52,2
070507ND602,8,25,0,1,27,33,20,8
070507ND604,7,11,0,1,15,18,0,0
070507ND605,3,5,0,1,7,8,0,0
070507ND607,9,30,0,1,38,39,0,0
070507ND608,5,6,0,1,11,11,0,0
070507ND610,12,6,0,1,17,18,0,0
070507ND611,16,18,0,1,33,34,0,0
070507ND701,6,21,0,0,25,27,0,0
070507ND702,9,8,0,1,15,17,0,0
070507ND703,3,7,0,1,8,10,26,2
070507ND704,3,10,0,1,9,13,0,0
070507ND706,13,44,0,0,57,57,0,0
070507ND708,2,10,0,0,12,12,0,0
070507ND802,5,8,0,1,11,13,0,0
070507ND804,3,9,0,1,12,12,225,1
070507ND805,6,28,0,0,34,34,40,2
070507ND806,10,17,0,1,25,27,0,0
070507ND812,19,27,0,1,45,46,61,3
070507ND901,4,1,0,1,4,5,21,1
070507ND902,9,24,0,0,33,33,0,0
070509ND101,31,104,0,2,131,135,60,3
070509ND401,18,34,0,1,51,52,123,10
070509ND402,14,35,0,1,49,49,59,2
070511ND101,0,3,0,1,3,3,0,0
070511ND301,0,8,0,0,8,8,0,0
070511ND401,0,11,0,0,10,11,21,1
070512ND201,7,53,0,1,59,60,212,53
070512ND202,2,15,0,1,17,17,0,0
070512ND301,3,2,0,1,5,5,0,0
070512ND601,2,11,0,1,12,13,0,0
7060107901,1,23,0,0,24,24,0,0
7060107902,0,38,0,0,35,38,0,0
7060107903,0,22,0,0,22,22,0,0
7060107904,0,37,0,0,33,37,486,22
7060107906,10,0,0,0,10,10,135,9
7060107907,50,0,0,0,48,50,86,12
7060107908,28,2,0,0,30,30,0,0
7060108001,0,24,0,0,24,24,0,0
7060108101,1,11,0,0,11,12,0,0
7060108102,1,32,0,0,28,33,10,1
7060108103,0,28,0,0,26,28,0,0
7060108104,24,0,0,0,24,24,0,0
7060108105,13,0,0,0,13,13,520,10
7060108106,39,2,0,0,35,41,0,0
7060108201,7,2,0,0,9,9,157,9
7060108301,1,9,0,0,10,10,6,2
7060108401,0,50,0,0,46,50,0,0
7060108601,1,8,0,0,9,9,0,0
7060108602,1,16,0,0,17,17,82,14
7060108603,2,6,0,0,8,8,0,0
7060108604,1,34,0,0,31,35,205,17
7060108701,0,28,0,0,27,28,260,13
7060108702,1,27,0,0,28,28,0,0
7060108901,1,27,0,0,28,28,0,0
7060108902,25,8,0,0,27,33,17,17
7060108903,29,1,0,0,26,30,0,0
7060109101,9,14,0,0,23,23,0,0
7060109102,0,20,0,0,20,20,14,1
7060109103,0,56,0,0,56,56,50,1
7060109104,16,2,0,0,17,18,0,0
7060109105,27,4,0,0,31,31,0,0
7060109201,0,15,0,0,15,15,70,9
7060109202,0,26,0,0,26,26,0,0
7060109203,18,2,0,0,20,20,0,0
7060109204,26,1,0,0,27,27,60,20
7060109601,14,28,0,0,42,42,0,0
7060114901,2,55,0,0,49,57,0,0
7060115301,6,4,0,1,10,10,54,6
7060115302,1,14,0,0,15,15,45,4
7060115303,0,35,0,0,29,35,0,0
7060115304,15,0,0,0,15,15,14,4
7060207901,7,6,0,0,13,13,0,0
7060207902,1,24,0,0,25,25,0,0
7060208003,5,0,0,0,5,5,0,0
7060208004,8,4,0,0,11,12,0,0
7060208005,0,19,0,0,18,19,0,0
7060208101,0,6,0,0,6,6,0,0
7060208102,11,32,0,0,40,43,0,0
7060208301,7,9,0,0,14,16,0,0
7060208303,11,0,0,0,11,11,0,0
7060208304,0,6,0,1,6,6,20,4
7060208305,0,11,0,0,11,11,0,0
7060208306,0,22,0,0,21,22,0,0
7060208307,46,3,0,0,48,49,0,0
7060208308,10,10,0,0,20,20,0,0
7060208601,9,11,0,0,20,20,0,0
7060208602,12,0,0,1,12,12,0,0
7060208701,8,37,0,1,45,45,0,0
7060208801,0,56,0,0,56,56,0,0
7060208902,28,0,0,0,28,28,210,5
7060208903,0,16,0,0,16,16,0,0
7060208904,3,0,0,0,2,3,0,0
7060208905,0,33,0,0,32,33,0,0
7060208906,4,12,0,0,14,16,70,9
7060208907,10,15,0,0,24,25,0,0
7060208908,0,7,0,0,7,7,5,1
7060209101,0,35,0,0,35,35,0,0
7060209102,25,0,0,0,25,25,220,1
7060209103,0,15,0,0,15,15,0,0
7060209104,0,5,0,0,5,5,0,0
7060209105,1,22,0,0,23,23,0,0
7060209106,13,9,0,0,22,22,0,0
7060209107,9,9,0,0,18,18,0,0
7060209108,11,23,0,0,32,34,0,0
7060209201,11,24,0,0,35,35,0,0
7060209202,0,26,0,1,26,26,0,0
7060209203,1,33,0,0,33,34,3,1
7060209204,0,24,0,1,24,24,44,15
7060214901,3,5,0,0,8,8,0,0
7060214902,0,40,0,0,40,40,0,0
7060214903,1,39,0,0,40,40,0,0
7060214904,12,17,0,0,28,29,0,0
7060214905,7,6,0,0,13,13,0,0
7060214906,8,14,0,0,21,22,1078,22
7060214907,7,9,0,0,16,16,0,0
7060214908,7,23,0,0,28,30,10,2
7060214909,3,11,0,0,14,14,0,0
7060215201,17,12,0,0,29,29,0,0
7060215302,4,23,0,0,27,27,420,2
7060215303,4,24,0,0,28,28,0,0
7060215304,28,0,0,0,27,28,0,0
7060215305,0,21,0,0,20,21,0,0
7060215306,14,8,0,0,21,22,0,0
7060215307,0,16,0,0,16,16,0,0
7060215308,0,11,0,0,11,11,612,8
7060215309,28,10,0,0,37,38,0,0
7060215310,0,3,0,0,3,3,0,0
7060215311,0,15,0,0,15,15,0,0
7060215312,22,11,0,0,32,33,0,0
7060215313,2,2,0,0,4,4,0,0
7060307601,10,148,0,2,158,158,0,0
7060307901,0,11,0,1,11,11,0,0
7060308101,1,13,0,1,11,14,0,0
7060308201,5,61,0,2,65,66,15,1
7060308202,2,16,0,0,15,18,0,0
7060308901,3,9,0,0,8,12,250,10
7060308902,3,15,0,0,18,18,0,0
7060309001,0,11,0,0,11,11,67,10
7060309101,3,40,0,0,42,43,0,0
7060309102,13,36,0,1,46,49,64,2
7060309103,2,27,0,0,29,29,0,0
7060309104,4,42,0,2,44,46,540,45
7060309105,0,19,0,0,19,19,0,0
7060309106,0,9,0,1,8,9,135,7
7060309501,7,61,0,2,66,68,411,68
7060309502,4,80,0,1,84,84,0,0
7060314902,29,124,0,2,151,153,0,0
7060314903,4,27,0,0,31,31,620,31
7060314904,5,43,0,0,48,48,0,0
7060314905,14,95,0,1,104,109,0,0
7060315001,11,108,0,1,114,119,10,1
7060315301,0,9,0,1,9,9,0,0
7060315302,0,26,0,0,25,26,224,1
7060315303,5,61,0,0,65,66,2054,65
7060315304,0,10,0,1,9,10,0,0
7060315305,8,27,0,0,34,35,0,0
7060315306,3,31,0,0,34,34,1834,34
7060315307,0,20,0,0,20,20,0,0
7060407310,0,2,0,1,2,2,0,0
7060407901,0,3,0,1,2,3,0,0
7060407903,2,2,0,0,3,4,0,0
7060407904,5,8,0,1,12,13,0,0
7060407905,3,1,0,1,4,4,20,1
7060407906,0,2,0,1,2,2,3,1
7060407907,0,2,0,1,2,2,0,0
7060407908,5,0,0,1,5,5,0,0
7060407909,2,1,0,1,2,3,0,0
7060407910,0,12,0,1,11,12,0,0
7060408101,2,1,0,1,3,3,0,0
7060408102,2,1,0,1,3,3,0,0
7060408103,2,1,0,1,3,3,0,0
7060408104,1,3,0,1,3,4,0,0
7060408106,5,7,0,1,10,12,0,0
7060408107,1,11,0,1,11,12,0,0
7060408108,0,9,0,1,6,9,0,0
7060408201,5,4,0,1,8,9,3,1
7060408202,0,2,0,1,2,2,0,0
7060408203,1,2,0,1,3,3,20,2
7060408204,0,10,0,1,10,10,0,0
7060408205,1,1,0,0,1,2,0,0
7060408206,2,3,0,1,5,5,0,0
7060408207,2,1,0,1,3,3,0,0
7060408208,1,2,0,1,3,3,0,0
7060408209,2,2,0,1,4,4,0,0
7060408210,2,7,0,1,9,9,0,0
7060408301,1,3,0,1,3,4,0,0
7060408302,0,5,0,1,3,5,0,0
7060408303,0,4,0,1,4,4,0,0
7060408304,2,4,0,1,5,6,0,0
7060408305,0,2,0,1,2,2,0,0
7060408306,2,1,0,1,2,3,0,0
7060408307,0,5,0,1,5,5,0,0
7060408308,0,8,0,1,8,8,0,0
7060408309,0,2,0,1,1,2,0,0
7060408310,1,3,0,1,3,4,0,0
7060408311,2,2,0,1,4,4,0,0
7060408312,0,5,0,1,4,5,0,0
7060408401,8,4,0,1,12,12,0,0
7060408402,0,12,0,1,11,12,0,0
7060408601,1,2,0,1,2,3,0,0
7060408602,2,4,0,1,4,6,0,0
7060408603,0,4,0,1,3,4,0,0
7060408604,2,0,0,1,2,2,0,0
7060408605,0,5,0,1,5,5,0,0
7060408606,1,5,0,1,6,6,10,1
7060408607,0,4,0,1,4,4,0,0
7060408701,1,2,0,1,3,3,13,3
7060408702,0,11,0,1,7,11,55,6
7060408703,3,0,0,1,2,3,0,0
7060408704,1,4,0,1,4,5,0,0
7060408705,2,1,0,1,2,3,0,0
7060408706,2,1,0,0,3,3,0,0
7060408707,2,2,0,0,3,4,0,0
7060408708,4,1,0,1,3,5,0,0
7060408709,0,10,0,1,9,10,30,4
7060408808,1,1,0,1,0,2,0,0
7060408809,0,4,0,1,2,4,0,0
7060408902,0,4,0,1,4,4,0,0
7060408903,3,1,0,1,2,4,0,0
7060408904,1,3,0,1,4,4,0,0
7060408905,0,5,0,1,5,5,0,0
7060408906,2,2,0,1,4,4,0,0
7060408907,2,4,0,1,6,6,0,0
7060408908,2,1,0,0,1,3,0,0
7060408909,0,4,0,1,4,4,0,0
7060409001,2,3,0,1,4,5,0,0
7060409002,3,2,0,1,4,5,0,0
7060409103,0,8,0,1,8,8,0,0
7060409106,0,4,0,1,3,4,0,0
7060409107,0,3,0,1,3,3,0,0
7060409108,0,8,0,1,2,8,0,0
7060409110,1,2,0,1,3,3,0,0
7060409111,0,2,0,1,1,2,30,1
7060409112,1,1,0,1,2,2,0,0
7060409113,2,5,0,1,4,7,0,0
7060409115,0,4,0,1,4,4,0,0
7060409116,2,9,0,1,8,11,124,5
7060409117,0,6,0,1,5,6,0,0
7060409201,3,1,0,1,2,4,0,0
7060409202,4,0,0,1,2,4,0,0
7060409203,0,3,0,1,3,3,0,0
7060409204,0,4,0,1,4,4,0,0
7060409205,4,2,0,1,5,6,10,2
7060409206,0,5,0,1,4,5,0,0
7060409207,6,0,0,1,4,6,12,4
7060409208,0,12,0,1,6,12,32,11
7060409303,0,6,0,1,5,6,0,0
7060409504,1,5,0,1,5,6,0,0
7060414902,0,4,0,1,4,4,0,0
7060414903,0,3,0,1,3,3,0,0
7060414905,1,8,0,1,8,9,0,0
7060414906,0,13,0,0,12,13,0,0
7060414907,2,16,0,1,15,18,0,0
7060418301,1,4,0,1,3,5,0,0
7060508001,1,4,0,1,5,5,0,0
7060508002,0,4,0,0,4,4,0,0
7060508201,0,8,0,1,8,8,6,1
7060508401,0,5,0,1,4,5,0,0
7060508601,0,6,0,1,6,6,0,0
7060508602,1,9,0,1,10,10,0,0
7060508603,0,9,0,1,9,9,0,0
7060508901,0,5,0,0,5,5,0,0
7060508902,0,3,0,1,1,3,0,0
7060508903,0,5,0,1,4,5,0,0
7060508904,0,4,0,1,3,4,0,0
7060508905,3,4,0,1,7,7,0,0
7060508906,0,5,0,0,3,5,0,0
7060509101,0,10,0,1,9,10,0,0
7060509102,0,3,0,1,3,3,0,0
7060509103,0,3,0,1,3,3,0,0
7060608101,0,4,0,1,3,4,0,0
7060608102,1,2,0,0,3,3,0,0
7060608201,0,6,0,1,6,6,0,0
7060608601,0,8,0,1,8,8,0,0
7060608602,0,5,0,1,5,5,0,0
7060609001,0,8,0,1,3,8,0,0
7060609101,0,9,0,1,9,9,0,0
7060609102,0,18,0,1,18,18,0,0
7060609201,0,4,0,0,4,4,0,0
7060615303,0,8,0,1,8,8,0,0
7060615304,1,10,0,1,11,11,699,7
7070103001,34,0,0,0,34,34,0,0
7070103002,0,77,0,0,77,77,0,0
7070103003,0,43,0,0,42,43,17,2
7070103004,17,8,0,0,25,25,89,24
7070103005,25,0,0,0,25,25,0,0
7070103101,83,2,0,0,85,85,372,64
7070103102,37,0,0,0,37,37,104,34
7070103201,1,29,0,0,28,30,320,16
7070103202,29,0,0,0,27,29,350,28
7070104101,27,24,0,0,50,51,254,44
7070104102,0,53,0,0,53,53,0,0
7070104103,34,2,0,0,36,36,0,0
7070104201,23,27,0,0,50,50,120,2
7070104301,0,99,0,0,99,99,10,4
7070104302,2,102,0,0,102,104,0,0
7070104303,36,2,0,0,38,38,0,0
7070104304,0,43,0,0,42,43,367,22
7070104305,0,75,0,0,73,75,4,1
7070104306,1,94,0,0,92,95,0,0
7070104307,44,20,0,0,63,64,0,0
7070104308,74,1,0,0,69,75,183,22
7070104309,42,10,0,0,51,52,79,26
7070104310,39,2,0,0,39,41,0,0
7070104311,0,1,0,0,1,1,0,0
7070104401,1,0,0,0,1,1,0,0
7070105701,9,36,0,0,45,45,0,0
7070105702,23,46,0,0,65,69,0,0
7070105801,13,29,0,0,42,42,248,11
7070105802,0,59,0,0,52,59,53,5
7070105803,7,24,0,0,31,31,60,6
7070105804,26,45,0,0,67,71,0,0
7070105805,23,28,0,0,49,51,60,1
7070109401,1,30,0,0,31,31,2,1
7070109402,48,13,0,0,60,61,0,0
7070109403,3,67,0,0,62,70,0,0
7070109404,1,52,0,0,53,53,0,0
7070109405,38,4,0,0,41,42,0,0
7070109406,19,4,0,0,23,23,400,23
7070109601,0,39,0,0,36,39,0,0
7070109602,0,52,0,0,46,52,0,0
7070109603,18,12,0,0,30,30,5,1
7070109701,0,35,0,0,35,35,0,0
7070109702,6,23,0,0,29,29,0,0
7070109703,38,11,0,0,44,49,0,0
7070109801,1,59,0,0,56,60,72,17
7070109802,19,42,0,0,56,61,0,0
7070109901,0,54,0,0,53,54,0,0
7070109902,42,1,0,0,42,43,0,0
7070110001,5,17,0,0,21,22,0,0
7070110002,17,22,0,0,37,39,690,2
7070110003,14,21,0,0,33,35,155,31
7070110101,0,43,0,0,43,43,0,0
7070110201,0,37,0,0,37,37,0,0
7070110202,26,1,0,0,27,27,397,18
7070110301,3,65,0,0,66,68,62,2
7070110302,40,0,0,0,40,40,36,33
7070110303,11,21,0,0,24,32,741,25
7070110401,3,37,0,0,40,40,161,21
7070110402,0,59,0,0,56,59,0,0
7070110403,46,1,0,0,43,47,0,0
7070110501,0,59,0,0,52,59,0,0
7070110502,1,58,0,0,56,59,118,19
7070110503,12,10,0,0,22,22,0,0
7070110504,32,1,0,0,31,33,0,0
7070110505,34,5,0,0,33,39,13,3
7070110601,1,47,0,0,48,48,105,5
7070110602,1,64,0,0,60,65,0,0
7070110603,5,26,0,0,28,31,0,0
7070110604,45,13,0,0,58,58,0,0
7070110701,62,6,0,0,57,68,0,0
7070110702,0,81,0,0,74,81,0,0
7070110801,1,61,0,0,56,62,90,6
7070110802,0,59,0,0,58,59,0,0
7070110803,25,0,0,0,25,25,0,0
7070110901,12,52,0,0,60,64,548,27
7070110902,39,1,0,0,40,40,60,1
7070110903,1,46,0,0,46,47,0,0
7070110904,41,7,0,0,45,48,0,0
7070111101,13,17,0,0,30,30,0,0
7070111102,11,32,0,0,42,43,0,0
7070111103,19,10,0,0,29,29,400,26
7070111201,1,34,0,0,33,35,0,0
7070111202,29,7,0,0,34,36,365,34
7070111203,37,6,0,0,40,43,112,19
7070111301,0,66,0,0,66,66,6,1
7070111302,1,40,0,0,40,41,10,2
7070111303,35,2,0,0,37,37,144,31
7070111304,1,47,0,0,47,48,53,7
7070111305,17,2,0,0,19,19,0,0
7070111401,0,75,0,0,70,75,9,1
7070111402,0,43,0,0,43,43,0,0
7070111403,36,8,0,0,42,44,0,0
7070111404,42,5,0,0,41,47,0,0
7070111405,1,36,0,0,36,37,0,0
7070111701,0,56,0,0,56,56,0,0
7070111702,1,81,0,0,79,82,365,10
7070111703,26,49,0,0,74,75,0,0
7070111801,0,77,0,0,75,77,419,42
7070111802,46,1,0,0,47,47,0,0
7070111803,53,0,0,0,53,53,0,0
7070111804,0,52,0,0,52,52,212,1
7070112101,22,18,0,0,40,40,0,0
7070112102,42,26,0,0,68,68,168,56
7070112103,14,13,0,0,27,27,33,1
7070112201,47,37,0,0,83,84,0,0
7070112202,21,8,0,0,28,29,0,0
7070112203,20,17,0,0,36,37,105,16
7070112301,0,71,0,0,70,71,0,0
7070112302,7,29,0,0,36,36,0,0
7070112303,10,24,0,0,34,34,0,0
7070112304,57,1,0,0,57,58,1480,48
7070112305,37,4,0,0,41,41,296,37
7070112306,63,8,0,0,63,71,0,0
7070112401,73,5,0,0,78,78,80,11
7070112402,1,33,0,0,34,34,0,0
7070112403,0,78,0,0,77,78,40,2
7070112404,36,0,0,0,35,36,100,4
7070112405,0,43,0,0,43,43,0,0
7070112501,2,31,0,0,33,33,106,10
7070112502,33,10,0,0,43,43,0,0
7070112503,77,0,0,0,77,77,0,0
7070112504,1,110,0,0,109,111,16,2
7070112505,15,1,0,0,16,16,45,9
7070112701,17,49,0,0,66,66,0,0
7070112702,0,60,0,0,60,60,0,0
7070112801,0,53,0,0,53,53,0,0
7070112802,30,1,0,0,31,31,0,0
7070112803,14,13,0,0,27,27,0,0
7070112804,21,6,0,0,27,27,70,1
7070113501,1,96,0,0,97,97,0,0
7070113601,0,80,0,0,80,80,20,1
7070113602,78,1,0,0,77,79,0,0
7070113603,67,2,0,0,69,69,0,0
7070205802,5,8,0,0,13,13,0,0
7070209501,31,0,0,0,31,31,5,1
7070209502,13,11,0,0,24,24,0,0
7070209503,0,27,0,0,27,27,0,0
7070209504,0,35,0,0,34,35,0,0
7070209601,0,8,0,0,7,8,0,0
7070209602,1,15,0,1,15,16,34,5
7070209701,9,6,0,0,13,15,0,0
7070209801,10,0,0,0,10,10,24,8
7070209901,0,3,0,0,3,3,0,0
7070210001,11,18,0,0,28,29,1460,29
7070210301,4,12,0,0,16,16,580,16
7070210601,8,1,0,0,9,9,0,0
7070210901,5,31,0,0,36,36,0,0
7070210902,6,34,0,0,40,40,0,0
7070211201,4,16,0,0,19,20,0,0
7070211301,1,41,0,1,42,42,12,2
7070211302,0,19,0,0,18,19,0,0
7070211701,8,22,0,0,29,30,0,0
7070212301,2,16,0,0,18,18,286,1
7070303001,0,9,0,1,8,9,0,0
7070303002,6,41,0,0,47,47,0,0
7070303003,3,17,0,0,20,20,0,0
7070303004,2,18,0,0,19,20,0,0
7070303005,4,9,0,0,12,13,0,0
7070303006,9,12,0,1,19,21,0,0
7070303007,14,50,0,0,64,64,640,64
7070303008,9,17,0,0,13,26,0,0
7070303009,0,11,0,1,8,11,0,0
7070303101,1,13,0,1,14,14,1,1
7070303102,3,7,0,1,10,10,0,0
7070303103,1,46,0,0,45,47,119,43
7070303104,0,16,0,0,15,16,0,0
7070303105,4,4,0,1,8,8,120,8
7070303106,6,15,0,0,18,21,0,0
7070303107,9,96,0,0,105,105,850,105
7070303108,1,19,0,0,17,20,20,2
7070303109,0,10,0,0,9,10,0,0
7070303110,7,34,0,0,40,41,0,0
7070303111,0,8,0,1,8,8,0,0
7070303112,2,10,0,0,12,12,0,0
7070303113,5,9,0,0,11,14,0,0
7070303114,11,51,0,0,31,62,0,0
7070303115,3,11,0,0,13,14,0,0
7070303201,2,8,0,1,9,10,0,0
7070303202,2,18,0,0,20,20,0,0
7070303203,2,12,0,0,13,14,0,0
7070303204,0,13,0,1,11,13,30,6
7070303205,2,9,0,1,10,11,0,0
7070303206,11,32,0,0,42,43,0,0
7070303207,5,4,0,1,7,9,0,0
7070303208,3,26,0,0,28,29,0,0
7070304101,5,5,0,1,10,10,0,0
7070304103,4,70,0,0,73,74,0,0
7070304104,0,33,0,0,33,33,0,0
7070304105,6,20,0,0,26,26,318,20
7070304201,0,16,0,0,16,16,0,0
7070304301,0,10,0,1,8,10,0,0
7070304302,2,16,0,0,18,18,0,0
7070304303,5,16,0,0,20,21,0,0
7070304304,2,14,0,0,16,16,0,0
7070304305,0,12,0,1,12,12,180,12
7070304306,1,14,0,0,13,15,0,0
7070304307,3,20,0,0,18,23,0,0
7070304308,3,8,0,1,5,11,0,0
7070304309,7,9,0,0,11,16,0,0
7070304401,3,10,0,0,12,13,0,0
7070304402,13,43,0,0,43,56,0,0
7070304403,6,10,0,1,16,16,354,15
7070304404,0,9,0,1,9,9,0,0
7070304405,7,30,0,0,35,37,0,0
7070304406,4,14,0,1,11,18,0,0
7070305701,17,53,0,0,69,70,216,1
7070305702,0,33,0,0,33,33,127,31
7070305703,6,39,0,0,43,45,0,0
7070305704,4,44,0,0,46,48,2784,48
7070305705,4,16,0,0,19,20,0,0
7070305706,11,38,0,0,47,49,0,0
7070305801,6,24,0,0,30,30,5,1
7070305802,3,25,0,1,22,28,60,1
7070305803,0,10,0,1,10,10,0,0
7070305804,3,13,0,0,16,16,0,0
7070305805,0,20,0,0,20,20,5,1
7070305806,5,42,0,0,45,47,1178,47
7070305807,17,63,0,0,79,80,0,0
7070305808,5,31,0,0,35,36,0,0
7070305809,2,10,0,0,12,12,0,0
7070305810,2,5,0,0,6,7,0,0
7070305811,4,39,0,0,42,43,0,0
7070305812,10,69,0,0,77,79,0,0
7070305814,3,42,0,0,44,45,0,0
7070305815,12,34,0,0,46,46,0,0
7070305816,3,3,0,0,6,6,0,0
7070309401,1,63,0,0,62,64,0,0
7070309402,3,16,0,1,10,19,0,0
7070309403,1,13,0,1,13,14,0,0
7070309501,6,50,0,0,56,56,0,0
7070309502,0,5,0,1,5,5,90,5
7070309503,1,21,0,0,21,22,0,0
7070309504,1,65,0,2,66,66,0,0
7070309601,5,14,0,0,19,19,0,0
7070309701,1,21,0,0,21,22,0,0
7070309702,3,18,0,0,20,21,203,17
7070309703,1,38,0,1,39,39,0,0
7070309801,4,49,0,1,51,53,0,0
7070309901,0,5,0,1,5,5,0,0
7070309902,0,15,0,1,15,15,0,0
7070309903,2,8,0,1,9,10,0,0
7070309904,1,9,0,0,10,10,0,0
7070310101,0,27,0,0,26,27,25,1
7070310201,0,2,0,1,2,2,0,0
7070310301,16,87,0,1,101,103,0,0
7070310302,0,8,0,1,8,8,0,0
7070310303,13,38,0,1,51,51,750,50
7070310304,16,183,0,0,195,199,2790,179
7070310305,4,61,0,0,64,65,0,0
7070310306,4,77,0,0,78,81,0,0
7070310307,6,51,0,0,54,57,0,0
7070310308,2,20,0,0,22,22,0,0
7070310401,3,58,0,1,60,61,0,0
7070310502,11,51,0,0,61,62,0,0
7070310503,3,25,0,0,27,28,0,0
7070310504,1,13,0,0,14,14,0,0
7070310505,1,21,0,1,22,22,0,0
7070310506,15,59,0,0,71,74,38,1
7070310507,14,31,0,0,42,45,0,0
7070310601,0,12,0,1,11,12,0,0
7070310602,1,8,0,1,8,9,0,0
7070310603,1,22,0,0,22,23,0,0
7070310604,3,74,0,0,73,77,295,1
7070310605,0,9,0,1,9,9,0,0
7070310606,5,30,0,0,32,35,0,0
7070310702,2,34,0,0,34,36,180,36
7070310703,0,8,0,1,8,8,0,0
7070310704,0,9,0,1,9,9,0,0
7070310705,1,12,0,1,13,13,390,13
7070310901,6,32,0,0,37,38,74,37
7070310902,3,59,0,0,60,62,0,0
7070310903,10,29,0,1,38,39,585,39
7070310905,6,9,0,1,13,15,0,0
7070310906,0,35,0,0,34,35,0,0
7070310907,0,38,0,0,38,38,1093,38
7070310908,11,63,0,1,73,74,62,2
7070310909,11,69,0,0,79,80,0,0
7070311001,2,8,0,1,10,10,0,0
7070311101,13,95,0,1,105,108,703,89
7070311102,6,36,0,0,42,42,0,0
7070311103,3,11,0,0,13,14,15,1
7070311301,3,102,0,0,104,105,0,0
7070311302,1,8,0,0,9,9,0,0
7070311303,0,9,0,1,8,9,10,1
7070311304,6,30,0,0,35,36,0,0
7070311401,1,19,0,0,19,20,500,20
7070311402,0,12,0,0,12,12,0,0
7070311403,1,24,0,0,24,25,1008,24
7070311404,0,35,0,0,35,35,0,0
7070311405,0,13,0,0,13,13,0,0
7070311406,0,9,0,1,7,9,0,0
7070311407,4,36,0,1,40,40,0,0
7070311701,10,71,0,0,80,81,0,0
7070311702,5,30,0,0,35,35,0,0
7070311703,0,14,0,1,14,14,0,0
7070311704,7,92,0,0,98,99,0,0
7070311705,13,80,0,2,88,93,900,4
7070311801,0,40,0,0,39,40,0,0
7070311802,6,55,0,0,59,61,0,0
7070311803,6,54,0,1,59,60,0,0
7070311901,0,13,0,0,13,13,0,0
7070311902,0,8,0,1,8,8,0,0
7070311903,1,13,0,0,13,14,315,9
7070311904,0,26,0,0,25,26,0,0
7070312101,1,14,0,0,10,15,360,15
7070312102,2,13,0,0,15,15,0,0
7070312103,6,26,0,0,29,32,0,0
7070312202,0,15,0,0,14,15,0,0
7070312203,0,9,0,1,9,9,0,0
7070312204,5,15,0,0,20,20,0,0
7070312205,2,12,0,1,14,14,187,7
7070312206,2,13,0,0,12,15,0,0
7070312207,4,15,0,0,19,19,64,12
7070312208,3,13,0,0,14,16,0,0
7070312209,6,11,0,0,16,17,0,0
7070312211,2,13,0,0,11,15,0,0
7070312301,1,24,0,0,25,25,0,0
7070312302,12,122,0,0,131,134,78,1
7070312303,5,36,0,0,41,41,1025,41
7070312304,11,73,0,0,79,84,1975,84
7070312305,6,49,0,0,54,55,49,5
7070312306,7,37,0,0,43,44,0,0
7070312307,0,46,0,0,46,46,0,0
7070312308,3,65,0,0,68,68,0,0
7070312309,2,34,0,0,36,36,0,0
7070312310,4,20,0,0,22,24,95,3
7070312311,2,7,0,0,9,9,0,0
7070312312,1,10,0,1,11,11,0,0
7070312313,2,33,0,0,35,35,898,35
7070312314,1,109,0,0,106,110,50,1
7070312315,3,54,0,0,56,57,0,0
7070312316,3,14,0,0,13,17,0,0
7070312401,1,10,0,1,11,11,0,0
7070312402,2,7,0,1,8,9,0,0
7070312403,0,11,0,1,11,11,0,0
7070312404,2,14,0,0,16,16,18,1
7070312405,13,49,0,0,62,62,0,0
7070312406,6,19,0,0,25,25,0,0
7070312407,2,8,0,1,10,10,0,0
7070312408,1,11,0,1,11,12,0,0
7070312409,4,12,0,0,16,16,0,0
7070312410,1,6,0,1,7,7,0,0
7070312411,0,10,0,1,10,10,0,0
7070312412,1,15,0,0,14,16,14,8
7070312413,2,14,0,0,15,16,0,0
7070312414,0,10,0,0,10,10,0,0
7070312501,1,10,0,1,11,11,0,0
7070312502,0,25,0,0,25,25,162,25
7070312503,4,36,0,0,40,40,0,0
7070312504,17,75,0,0,86,92,0,0
7070312505,8,44,0,0,52,52,0,0
7070312506,4,28,0,0,25,32,0,0
7070312507,5,11,0,0,16,16,700,14
7070312508,0,11,0,1,11,11,0,0
7070312509,1,13,0,0,13,14,0,0
7070312510,10,31,0,0,41,41,0,0
7070312511,2,74,0,0,76,76,0,0
7070312512,2,15,0,0,16,17,0,0
7070312513,1,10,0,1,10,11,0,0
7070312514,5,6,0,1,11,11,0,0
7070312601,1,12,0,1,13,13,0,0
7070312602,1,13,0,0,14,14,20,2
7070312603,1,8,0,1,9,9,68,9
7070312604,5,17,0,0,22,22,167,20
7070312605,0,10,0,0,9,10,0,0
7070312606,1,14,0,0,15,15,106,11
7070312607,1,23,0,0,24,24,0,0
7070312701,5,61,0,0,53,66,0,0
7070312702,0,27,0,1,27,27,0,0
7070312703,1,10,0,1,11,11,0,0
7070312704,1,10,0,1,11,11,0,0
7070312705,1,14,0,1,14,15,0,0
7070312706,1,8,0,1,9,9,0,0
7070312707,17,84,0,0,99,101,0,0
7070312801,0,9,0,1,9,9,0,0
7070312803,0,10,0,1,10,10,0,0
7070312804,0,16,0,1,16,16,0,0
7070312805,1,23,0,0,24,24,0,0
7070312806,3,13,0,0,16,16,690,16
7070313501,1,9,0,1,8,10,80,10
7070313502,2,10,0,1,10,12,0,0
7070313601,4,25,0,0,29,29,0,0
7070313602,5,8,0,1,12,13,0,0
7070313603,2,13,0,1,15,15,180,15
7070313604,1,4,0,0,3,5,10,1
7070313605,0,10,0,0,10,10,0,0
7070313606,5,5,0,1,5,10,0,0
7070314801,0,8,0,1,8,8,0,0
7070314901,1,8,0,0,8,9,0,0
7070315001,0,9,0,0,7,9,0,0
7070403001,12,14,0,0,20,26,0,0
7070403002,1,24,0,1,20,25,0,0
7070403003,0,16,0,0,8,16,0,0
7070403004,0,22,0,1,19,22,157,14
7070403005,7,19,0,1,21,26,0,0
7070403006,2,0,0,0,2,2,0,0
7070403007,7,0,0,1,5,7,0,0
7070403101,0,19,0,1,17,19,0,0
7070403102,15,0,0,0,13,15,0,0
7070403103,0,38,0,0,32,38,21,2
7070403104,34,2,0,0,32,36,0,0
7070403105,2,24,0,1,20,26,94,19
7070403106,17,8,0,1,23,25,0,0
7070403107,0,13,0,1,11,13,0,0
7070403108,11,2,0,1,11,13,0,0
7070403201,5,17,0,1,16,22,5,1
7070403202,15,1,0,1,9,16,0,0
7070403203,0,20,0,1,17,20,11,3
7070403204,6,7,0,0,10,13,0,0
7070404101,0,42,0,1,33,42,0,0
7070404102,14,10,0,1,18,24,0,0
7070404103,1,21,0,1,20,22,0,0
7070404104,0,13,0,1,11,13,0,0
7070404105,7,5,0,1,9,12,15,1
7070404201,6,5,0,1,9,11,0,0
7070404202,0,12,0,1,12,12,0,0
7070404203,10,6,0,1,13,16,0,0
7070404204,1,22,0,1,23,23,0,0
7070404205,16,2,0,1,16,18,0,0
7070404206,1,23,0,1,23,24,0,0
7070404301,8,9,0,1,10,17,0,0
7070404302,0,16,0,1,14,16,0,0
7070404303,29,12,0,1,24,41,0,0
7070404304,12,3,0,1,15,15,0,0
7070404305,1,15,0,1,12,16,0,0
7070404306,0,15,0,1,12,15,0,0
7070404307,7,5,0,1,8,12,0,0
7070404401,12,14,0,1,13,26,0,0
7070405701,1,22,0,1,21,23,0,0
7070405801,0,5,0,1,5,5,0,0
7070405802,3,14,0,1,15,17,0,0
7070405803,0,12,0,1,11,12,0,0
7070405804,3,4,0,1,3,7,0,0
7070409301,4,29,0,0,17,33,0,0
7070409302,14,6,0,1,9,20,15,1
7070409401,9,13,0,1,19,22,116,18
7070409402,0,12,0,1,10,12,0,0
7070409403,5,6,0,1,4,11,0,0
7070409404,3,9,0,1,11,12,0,0
7070409405,5,5,0,0,5,10,0,0
7070409406,5,31,0,1,15,36,0,0
7070409407,13,16,0,0,8,29,0,0
7070409408,3,4,0,1,4,7,0,0
7070409501,0,12,0,1,9,12,30,6
7070409502,0,15,0,1,11,15,3,1
7070409503,4,2,0,1,3,6,0,0
7070409504,1,11,0,1,8,12,0,0
7070409505,8,2,0,1,3,10,0,0
7070409506,0,5,0,1,2,5,0,0
7070409507,2,3,0,1,5,5,0,0
7070409601,1,4,0,1,5,5,0,0
7070409602,2,5,0,1,6,7,0,0
7070409603,1,3,0,1,4,4,0,0
7070409604,0,5,0,1,5,5,0,0
7070409605,3,18,0,1,8,21,0,0
7070409606,11,7,0,1,8,18,5,1
7070409607,2,4,0,1,4,6,0,0
7070409701,1,13,0,0,12,14,0,0
7070409702,2,19,0,0,15,21,0,0
7070409703,1,4,0,1,5,5,0,0
7070409704,1,8,0,1,8,9,0,0
7070409705,0,9,0,1,8,9,0,0
7070409706,3,9,0,1,8,12,3,1
7070409801,5,12,0,1,16,17,46,9
7070409802,7,0,0,1,7,7,0,0
7070409803,0,7,0,0,4,7,0,0
7070409901,2,9,0,1,9,11,0,0
7070409902,1,10,0,1,6,11,0,0
7070409903,0,12,0,1,12,12,0,0
7070409904,1,5,0,1,6,6,0,0
7070409905,0,4,0,0,4,4,0,0
7070409906,0,11,0,1,6,11,0,0
7070410001,0,11,0,1,9,11,0,0
7070410002,1,5,0,0,5,6,0,0
7070410003,0,10,0,1,10,10,0,0
7070410101,8,4,0,1,9,12,0,0
7070410102,2,11,0,1,10,13,0,0
7070410103,3,12,0,1,11,15,15,1
7070410104,3,18,0,1,17,21,30,2
7070410201,12,0,0,1,7,12,48,12
7070410202,0,17,0,1,9,17,0,0
7070410203,8,0,0,1,8,8,0,0
7070410204,0,11,0,1,7,11,0,0
7070410205,9,0,0,1,8,9,0,0
7070410206,0,19,0,1,19,19,0,0
7070410301,6,9,0,1,13,15,0,0
7070410302,4,3,0,1,7,7,0,0
7070410303,0,11,0,1,9,11,0,0
7070410304,0,5,0,1,5,5,0,0
7070410401,1,14,0,1,13,15,0,0
7070410402,6,5,0,1,6,11,0,0
7070410403,0,11,0,1,7,11,0,0
7070410404,3,3,0,1,3,6,0,0
7070410405,0,10,0,1,9,10,0,0
7070410406,2,9,0,1,9,11,10,1
7070410407,4,7,0,1,8,11,0,0
7070410408,0,11,0,1,10,11,0,0
7070410501,0,7,0,1,7,7,0,0
7070410502,2,16,0,1,18,18,10,1
7070410503,1,13,0,1,8,14,0,0
7070410504,0,14,0,1,13,14,20,1
7070410505,6,10,0,1,13,16,0,0
7070410506,4,6,0,1,7,10,19,1
7070410601,1,10,0,1,8,11,0,0
7070410602,4,9,0,1,11,13,0,0
7070410603,0,17,0,1,15,17,8,8
7070410604,1,10,0,1,9,11,0,0
7070410701,7,3,0,1,10,10,0,0
7070410702,4,2,0,1,2,6,0,0
7070410703,0,9,0,1,9,9,0,0
7070410704,7,1,0,0,7,8,4,3
7070410705,0,22,0,1,17,22,0,0
7070410706,0,15,0,1,15,15,40,1
7070410707,3,8,0,1,10,11,0,0
7070410801,4,4,0,1,8,8,0,0
7070410802,0,11,0,1,11,11,152,5
7070410803,9,3,0,1,6,12,0,0
7070410804,0,15,0,1,10,15,0,0
7070410901,0,5,0,1,5,5,0,0
7070410902,0,5,0,1,5,5,6,1
7070410903,0,5,0,1,4,5,0,0
7070410904,0,9,0,1,6,9,0,0
7070410905,1,4,0,1,5,5,0,0
7070411010,4,3,0,1,7,7,0,0
7070411101,1,8,0,1,7,9,0,0
7070411102,0,16,0,1,15,16,0,0
7070411103,0,11,0,1,11,11,0,0
7070411104,8,3,0,1,9,11,0,0
7070411201,0,6,0,1,5,6,0,0
7070411202,2,6,0,1,8,8,0,0
7070411203,2,10,0,1,9,12,60,5
7070411204,0,11,0,1,11,11,0,0
7070411301,0,12,0,1,8,12,0,0
7070411401,0,5,0,1,4,5,0,0
7070411402,4,1,0,1,4,5,0,0
7070411403,1,4,0,1,5,5,0,0
7070411404,0,5,0,1,5,5,0,0
7070411405,3,3,0,1,4,6,0,0
7070411406,0,11,0,1,9,11,0,0
7070411407,2,3,0,1,4,5,0,0
7070411408,0,5,0,1,5,5,0,0
7070411409,0,16,0,1,13,16,0,0
7070411501,4,2,0,1,5,6,0,0
7070411502,2,2,0,1,3,4,0,0
7070411503,0,10,0,1,10,10,0,0
7070411505,15,3,0,1,7,18,0,0
7070411506,0,15,0,1,15,15,0,0
7070411601,1,22,0,1,13,23,0,0
7070411602,0,20,0,1,19,20,0,0
7070411701,2,3,0,1,4,5,0,0
7070411702,5,12,0,1,13,17,0,0
7070411703,0,10,0,1,8,10,10,1
7070411704,0,16,0,1,14,16,0,0
7070411705,2,18,0,1,19,20,0,0
7070411706,0,11,0,1,8,11,0,0
7070411707,2,6,0,1,7,8,0,0
7070411708,0,11,0,1,10,11,0,0
7070411709,1,14,0,1,15,15,0,0
7070411710,0,5,0,1,4,5,0,0
7070411801,17,1,0,1,11,18,0,0
7070411802,5,0,0,1,4,5,0,0
7070411803,5,18,0,0,22,23,6,2
7070411901,0,14,0,1,11,14,0,0
7070411902,4,6,0,0,10,10,0,0
7070411903,7,4,0,1,8,11,40,5
7070411904,0,10,0,0,9,10,10,2
7070412101,19,7,0,0,25,26,0,0
7070412102,25,6,0,1,14,31,198,20
7070412201,18,13,0,0,13,31,0,0
7070412202,4,28,0,1,21,32,12,1
7070412203,12,1,0,1,9,13,7,3
7070412204,16,11,0,0,13,27,0,0
7070412205,12,2,0,1,11,14,0,0
7070412206,4,32,0,1,17,36,0,0
7070412207,15,22,0,1,31,37,30,1
7070412208,2,3,0,1,5,5,0,0
7070412209,3,2,0,1,4,5,20,4
7070412301,5,6,0,1,6,11,0,0
7070412302,1,10,0,1,10,11,24,8
7070412303,0,16,0,1,14,16,0,0
7070412304,0,12,0,1,11,12,0,0
7070412305,6,10,0,1,9,16,225,5
7070412306,2,15,0,1,12,17,0,0
7070412307,0,20,0,1,18,20,0,0
7070412308,13,0,0,0,10,13,0,0
7070412309,2,14,0,0,8,16,0,0
7070412401,7,16,0,1,17,23,75,9
7070412402,13,15,0,1,26,28,0,0
7070412403,0,35,0,1,23,35,0,0
7070412404,13,5,0,0,15,18,0,0
7070412405,0,31,0,1,29,31,15,1
7070412406,14,4,0,1,13,18,0,0
7070412501,28,7,0,1,20,35,138,20
7070412502,13,26,0,0,25,39,0,0
7070412503,12,2,0,0,7,14,0,0
7070412601,12,9,0,0,19,21,79,15
7070412602,0,32,0,1,29,32,0,0
7070412701,8,3,0,1,7,11,0,0
7070412702,0,15,0,0,12,15,4,1
7070412801,2,14,0,0,15,16,0,0
7070412802,8,0,0,1,7,8,0,0
7070412803,0,11,0,1,10,11,0,0
7070412804,13,3,0,1,12,16,0,0
7070412805,0,16,0,1,13,16,47,10
7070412806,3,23,0,0,22,26,43,5
7070412807,24,2,0,1,16,26,0,0
7070412808,0,14,0,1,13,14,0,0
7070413501,0,18,0,1,14,18,0,0
7070413502,13,5,0,1,4,18,0,0
7070413503,0,15,0,1,14,15,0,0
7070413504,11,3,0,1,14,14,0,0
7070413505,3,33,0,1,33,36,0,0
7070413506,14,17,0,1,19,31,33,13
7070507401,0,14,0,1,4,14,0,0
7070509601,0,3,0,1,3,3,70,1
7070510301,0,3,0,0,3,3,0,0
7070511401,0,15,0,0,14,15,0,0
7070603001,0,5,0,1,5,5,0,0
7070603002,0,9,0,1,3,9,0,0
7070603003,2,4,0,1,2,6,0,0
7070603202,1,5,0,0,5,6,0,0
7070604301,2,4,0,1,6,6,0,0
7070604302,0,5,0,1,5,5,100,5
7070604303,0,5,0,1,5,5,0,0
7070604304,2,7,0,1,4,9,0,0
7070604305,0,6,0,1,5,6,0,0
7070604307,0,5,0,1,5,5,0,0
7070604308,0,4,0,0,4,4,82,4
7070604309,2,5,0,1,2,7,0,0
7070604311,1,4,0,1,1,5,0,0
7070604312,1,1,0,1,0,2,0,0
7070604313,1,4,0,1,1,5,0,0
7070604401,0,5,0,1,5,5,0,0
7070604402,0,11,0,1,2,11,0,0
7070605701,0,6,0,1,5,6,0,0
7070607401,0,5,0,1,4,5,10,1
7070609301,0,5,0,1,5,5,0,0
7070609701,1,4,0,1,0,5,0,0
7070609702,0,4,0,1,4,4,0,0
7070609703,0,5,0,1,5,5,0,0
7070609901,0,5,0,1,5,5,0,0
7070609902,0,5,0,1,3,5,0,0
7070610101,0,5,0,1,5,5,0,0
7070610201,1,4,0,1,5,5,0,0
7070610202,0,5,0,1,5,5,0,0
7070610203,1,15,0,1,15,16,0,0
7070610801,0,5,0,1,5,5,0,0
7070610901,0,2,0,1,2,2,0,0
7070610902,0,2,0,1,2,2,0,0
7070610903,0,5,0,1,5,5,0,0
7070611301,0,5,0,1,5,5,0,0
7070611302,0,4,0,1,4,4,0,0
7070611401,0,5,0,1,2,5,0,0
7070611402,0,7,0,1,7,7,0,0
7070611501,0,5,0,1,5,5,0,0
7070611502,0,12,0,1,6,12,0,0
7070611503,0,5,0,1,5,5,0,0
7070611701,0,4,0,1,4,4,0,0
7070612101,0,4,0,1,2,4,0,0
7070612102,3,1,0,0,0,4,0,0
7070612103,0,5,0,1,5,5,0,0
7070612201,1,4,0,1,0,5,0,0
7070612202,2,9,0,1,9,11,0,0
7070612203,3,2,0,1,2,5,0,0
7070612204,0,5,0,1,4,5,0,0
7070612205,0,6,0,1,5,6,0,0
7070612206,0,5,0,1,5,5,0,0
7070612207,1,4,0,1,5,5,0,0
7070612208,1,3,0,1,4,4,0,0
7070612209,0,5,0,1,5,5,0,0
7070612210,0,5,0,1,5,5,0,0
7070612211,0,4,0,0,3,4,3,3
7070612212,1,4,0,1,4,5,0,0
7070612213,0,5,0,1,5,5,100,5
7070612214,0,10,0,1,9,10,100,10
7070612215,0,5,0,1,4,5,0,0
7070612216,0,5,0,1,3,5,0,0
7070612301,0,6,0,1,6,6,0,0
7070612302,0,5,0,1,5,5,0,0
7070612401,1,6,0,1,1,7,0,0
7070612402,1,4,0,1,1,5,0,0
7070612501,2,2,0,0,4,4,0,0
7070612504,0,4,0,0,4,4,0,0
7070612505,0,5,0,1,4,5,0,0
7070612702,0,5,0,1,5,5,0,0
7070612703,1,4,0,1,0,5,0,0
7070612704,0,5,0,1,4,5,0,0
7070612705,0,5,0,1,4,5,0,0
7070612706,2,4,0,1,5,6,0,0
7070612707,0,5,0,1,3,5,0,0
7070612708,0,6,0,1,6,6,0,0
7070612709,0,4,0,0,4,4,0,0
7070612710,1,3,0,0,2,4,0,0
7070612711,0,5,0,0,0,5,80,5
7070612801,2,3,0,1,0,5,0,0
7070612802,0,5,0,1,5,5,0,0
7070612803,0,8,0,1,7,8,0,0
7070612804,0,6,0,1,6,6,0,0
7070612805,0,5,0,1,1,5,0,0
7070613501,0,4,0,0,4,4,0,0
7070613502,0,6,0,1,3,6,0,0
7070613503,0,6,0,1,0,6,0,0
7070613504,1,8,0,1,3,9,0,0
7070613505,0,5,0,1,3,5,0,0
7070613506,0,5,0,1,0,5,0,0
7070613507,0,5,0,1,0,5,0,0
7070614601,2,4,0,1,6,6,0,0
7070614603,0,5,0,1,0,5,0,0
7070614604,2,4,0,1,1,6,0,0
7070614801,0,4,0,0,3,4,0,0
7070614802,1,4,0,1,5,5,0,0
7070614803,1,4,0,1,3,5,0,0
7070614804,1,4,0,1,5,5,5,1
7070614805,1,9,0,1,5,10,8,8
7070615001,0,10,0,1,10,10,20,1
7070904101,23,49,0,1,70,72,66,4
7070910601,24,58,0,1,81,82,48,4
7070911802,39,97,0,2,133,136,0,0
7070912402,27,78,0,0,102,105,0,0
7080111001,56,0,0,0,54,56,0,0
7080111002,0,30,0,0,30,30,952,30
7080111003,1,62,0,0,62,63,39,9
7080111004,31,1,0,0,32,32,125,22
7080112901,6,41,0,0,47,47,3,1
7080112902,43,1,0,0,44,44,0,0
7080113001,12,16,0,0,28,28,5,1
7080113101,0,86,0,0,86,86,65,9
7080113102,0,79,0,0,76,79,0,0
7080113103,52,0,0,0,52,52,10,2
7080113104,58,0,0,0,58,58,0,0
7080113301,0,15,0,0,15,15,0,0
7080113302,0,7,0,0,6,7,23,4
7080113303,8,1,0,0,9,9,0,0
7080113304,12,2,0,0,14,14,0,0
7080113305,33,9,0,0,42,42,0,0
7080113306,11,4,0,0,15,15,0,0
7080113307,10,3,0,0,13,13,0,0
7080113308,14,0,0,0,14,14,34,13
7080113309,20,3,0,0,22,23,0,0
7080113310,15,6,0,0,21,21,0,0
7080113311,15,11,0,0,25,26,0,0
7080113312,8,2,0,0,10,10,0,0
7080113313,19,0,0,0,19,19,220,1
7080113314,11,5,0,0,16,16,0,0
7080113315,0,51,0,0,48,51,0,0
7080113401,11,33,0,0,38,44,0,0
7080113402,4,40,0,0,44,44,0,0
7080113403,29,14,0,0,43,43,0,0
7080113404,26,4,0,0,29,30,5,1
7080113405,37,0,0,0,37,37,0,0
7080113601,17,47,0,0,64,64,0,0
7080113602,1,34,0,0,35,35,0,0
7080113603,15,13,0,0,28,28,8,8
7080113604,16,18,0,0,34,34,0,0
7080113605,20,37,0,0,57,57,0,0
7080113606,39,0,0,0,39,39,7,1
7080113701,5,36,0,0,41,41,0,0
7080113702,46,2,0,0,48,48,0,0
7080113801,1,35,0,0,36,36,0,0
7080113802,48,1,0,0,49,49,0,0
7080113803,0,60,0,0,60,60,0,0
7080113804,50,0,0,0,50,50,980,49
7080113805,0,70,0,0,69,70,0,0
7080113806,1,70,0,0,70,71,482,29
7080113807,60,2,0,0,62,62,0,0
7080113808,29,23,0,0,48,52,0,0
7080113809,33,4,0,0,37,37,156,5
7080113901,0,29,0,0,28,29,0,0
7080113902,27,1,0,0,28,28,9,3
7080113903,0,20,0,0,20,20,0,0
7080113904,17,0,0,0,17,17,0,0
7080114001,19,7,0,0,23,26,30,1
7080114002,29,2,0,0,31,31,0,0
7080114003,14,5,0,0,19,19,0,0
7080114004,0,35,0,0,35,35,0,0
7080114005,29,23,0,0,51,52,90,2
7080114006,1,18,0,0,18,19,30,6
7080114007,1,18,0,0,18,19,60,1
7080114008,1,22,0,0,23,23,0,0
7080114009,22,1,0,0,23,23,4,1
7080114010,18,0,0,0,18,18,242,9
7080114011,14,0,0,0,13,14,7,1
7080114012,15,1,0,0,16,16,0,0
7080114013,15,4,0,0,19,19,0,0
7080114014,23,16,0,0,38,39,375,33
7080114101,20,12,0,0,31,32,60,1
7080114102,14,10,0,0,24,24,0,0
7080114103,1,60,0,0,61,61,750,46
7080114104,50,8,0,0,58,58,123,25
7080114201,1,51,0,0,50,52,0,0
7080114202,0,66,0,0,63,66,1,1
7080114203,39,0,0,0,39,39,0,0
7080114204,43,0,0,0,43,43,0,0
7080114301,21,0,0,0,21,21,75,20
7080114302,0,30,0,0,30,30,0,0
7080114303,0,75,0,0,73,75,53,3
7080114304,56,1,0,0,57,57,0,0
7080114401,1,87,0,0,88,88,0,0
7080114402,40,5,0,0,44,45,1,1
7080114501,1,69,0,0,64,70,1090,36
7080114502,0,61,0,0,58,61,750,30
7080114503,59,1,0,0,60,60,0,0
7080114504,63,4,0,0,60,67,187,61
7080114601,0,46,0,0,46,46,106,5
7080114602,46,0,0,0,46,46,172,38
7080114701,74,2,0,0,71,76,212,65
7080114702,1,59,0,0,60,60,0,0
7080114801,32,41,0,0,73,73,0,0
7080115001,2,32,0,0,34,34,241,28
7080115002,18,0,0,0,18,18,0,0
7080115101,22,35,0,0,51,57,0,0
7080115102,20,1,0,0,21,21,0,0
7080115103,0,32,0,0,27,32,204,1
7080115201,0,58,0,0,58,58,140,5
7080115202,15,3,0,0,18,18,0,0
7080115203,50,6,0,0,53,56,25,1
7080116401,16,25,0,0,38,41,1215,27
7080116501,10,49,0,0,59,59,5,1
7080116601,7,30,0,0,36,37,0,0
7080116602,25,7,0,0,32,32,258,6
7080116701,20,37,0,0,57,57,0,0
7080116702,12,24,0,0,33,36,76,12
7080116703,22,53,0,0,73,75,301,30
7080116704,15,34,0,0,47,49,0,0
7080116705,0,22,0,0,22,22,84,8
7080116706,19,10,0,0,29,29,5,1
7080116707,23,27,0,0,48,50,0,0
7080116708,8,12,0,0,20,20,0,0
7080116801,8,35,0,0,39,43,558,20
7080116802,11,41,0,0,46,52,0,0
7080116803,28,3,0,0,31,31,0,0
7080117201,11,20,0,0,31,31,118,19
7080117202,1,44,0,0,43,45,0,0
7080117203,24,1,0,0,25,25,0,0
7080117204,1,30,0,0,31,31,0,0
7080117205,19,7,0,0,26,26,220,1
7080117401,22,3,0,0,25,25,0,0
7080117402,1,50,0,0,51,51,0,0
070801DC101,0,39,0,0,39,39,5,1
070801DC102,35,0,0,0,30,35,0,0
070801DC501,17,15,0,0,28,32,5280,24
070801ND801,8,13,0,0,21,21,0,0
070801ND802,0,34,0,0,32,34,4,1
070801ND803,0,44,0,0,43,44,0,0
070801ND804,0,42,0,0,42,42,225,1
070801ND805,24,7,0,0,30,31,0,0
070801ND806,29,8,0,0,37,37,0,0
070801ND807,27,7,0,0,31,34,520,26
7080200601,11,48,0,0,59,59,0,0
7080200801,6,13,0,0,19,19,0,0
7080200802,14,24,0,1,37,38,0,0
7080216701,8,0,0,1,8,8,0,0
7080216702,2,6,0,0,8,8,0,0
7080216703,3,1,0,0,4,4,0,0
7080216704,1,22,0,0,23,23,0,0
7080216705,4,23,0,0,26,27,0,0
7080216706,2,24,0,0,26,26,316,3
7080216801,5,22,0,1,27,27,2,1
070802DC101,1,10,0,1,11,11,0,0
070802DC102,11,7,0,0,17,18,0,0
070802DC301,6,18,0,0,23,24,0,0
070802DC801,0,58,0,0,58,58,0,0
070802ND801,1,11,0,1,12,12,0,0
070802ND802,4,31,0,0,35,35,0,0
7080311001,0,9,0,1,9,9,0,0
7080311002,0,8,0,1,8,8,225,8
7080312001,0,11,0,1,9,11,0,0
7080312201,10,27,0,0,34,37,0,0
7080312901,0,12,0,1,12,12,206,12
7080312902,1,7,0,1,1,8,0,0
7080312903,0,12,0,1,12,12,252,12
7080312904,10,20,0,0,30,30,150,30
7080312905,3,92,0,0,87,95,3230,95
7080313001,0,10,0,1,10,10,0,0
7080313002,1,21,0,0,19,22,0,0
7080313003,2,69,0,0,71,71,0,0
7080313101,0,11,0,1,11,11,0,0
7080313102,0,11,0,1,10,11,0,0
7080313103,2,19,0,1,20,21,0,0
7080313201,1,10,0,1,10,11,0,0
7080313202,2,13,0,1,14,15,0,0
7080313203,0,9,0,1,7,9,0,0
7080313204,0,13,0,1,11,13,13,13
7080313205,2,18,0,0,20,20,440,20
7080313206,0,15,0,1,13,15,0,0
7080313207,1,8,0,1,9,9,0,0
7080313208,0,11,0,1,10,11,0,0
7080313209,0,14,0,1,14,14,0,0
7080313301,2,9,0,1,8,11,0,0
7080313302,0,12,0,1,11,12,0,0
7080313303,1,11,0,0,12,12,16,1
7080313305,5,20,0,1,25,25,0,0
7080313306,4,13,0,0,11,17,0,0
7080313401,9,31,0,0,39,40,526,40
7080313402,2,12,0,0,11,14,0,0
7080313403,3,13,0,0,14,16,184,16
7080313404,3,18,0,1,21,21,0,0
7080313405,6,14,0,0,19,20,0,0
7080313407,3,51,0,0,46,54,0,0
7080313408,6,12,0,0,17,18,0,0
7080313409,4,13,0,0,17,17,0,0
7080313410,1,10,0,0,9,11,0,0
7080313411,14,66,0,0,76,80,0,0
7080313412,1,15,0,0,8,16,0,0
7080313413,1,17,0,0,13,18,165,11
7080313414,5,14,0,0,19,19,0,0
7080313415,7,16,0,0,17,23,0,0
7080313601,0,57,0,0,56,57,220,1
7080313602,3,16,0,1,18,19,0,0
7080313603,2,57,0,0,58,59,0,0
7080313604,2,35,0,0,34,37,0,0
7080313605,0,42,0,0,42,42,1134,42
7080313606,4,57,0,0,56,61,2,1
7080313607,4,28,0,0,32,32,0,0
7080313608,7,66,0,0,72,73,0,0
7080313609,2,17,0,0,19,19,180,18
7080313610,0,80,0,1,80,80,0,0
7080313611,1,27,0,0,28,28,0,0
7080313612,5,39,0,2,44,44,0,0
7080313613,8,65,0,0,69,73,0,0
7080313614,6,44,0,0,50,50,0,0
7080313615,9,38,0,0,42,47,0,0
7080313616,4,80,0,0,82,84,134,4
7080313617,11,97,0,2,108,108,0,0
7080313618,14,72,0,0,86,86,0,0
7080313619,10,58,0,0,68,68,0,0
7080313620,13,146,0,0,156,159,0,0
7080313621,0,38,0,0,38,38,0,0
7080313622,18,98,0,0,110,116,0,0
7080313623,1,14,0,0,15,15,0,0
7080313624,4,22,0,0,26,26,0,0
7080313625,10,64,0,0,74,74,165,4
7080313626,2,32,0,0,31,34,0,0
7080313627,9,42,0,0,49,51,52,15
7080313628,9,75,0,1,84,84,0,0
7080313629,7,28,0,2,35,35,468,34
7080313630,8,49,0,1,57,57,0,0
7080313631,4,30,0,0,33,34,0,0
7080313633,6,55,0,1,59,61,565,55
7080313634,3,18,0,0,18,21,0,0
7080313635,4,38,0,0,42,42,0,0
7080313636,1,36,0,0,37,37,1258,37
7080313637,1,29,0,0,30,30,0,0
7080313638,3,34,0,0,36,37,0,0
7080313701,7,32,0,0,38,39,0,0
7080313702,7,61,0,0,61,68,0,0
7080313703,16,38,0,0,40,54,0,0
7080313704,7,32,0,0,31,39,0,0
7080313705,5,34,0,0,39,39,0,0
7080313706,3,12,0,0,14,15,0,0
7080313707,11,31,0,0,38,42,0,0
7080313708,3,10,0,1,10,13,0,0
7080313709,8,21,0,0,29,29,0,0
7080313710,1,11,0,0,9,12,0,0
7080313711,0,51,0,0,50,51,0,0
7080313712,3,10,0,0,12,13,0,0
7080313713,2,9,0,0,10,11,0,0
7080313714,1,8,0,1,9,9,0,0
7080313715,8,42,0,0,48,50,0,0
7080313801,0,18,0,0,18,18,0,0
7080313802,7,34,0,0,39,41,0,0
7080313803,4,18,0,0,14,22,0,0
7080313804,7,22,0,0,28,29,0,0
7080313805,4,14,0,0,16,18,0,0
7080313806,2,8,0,1,9,10,0,0
7080313807,2,9,0,0,11,11,0,0
7080313808,6,7,0,0,13,13,0,0
7080313809,6,28,0,0,33,34,0,0
7080313901,1,7,0,0,8,8,0,0
7080313902,2,16,0,0,17,18,0,0
7080313903,3,8,0,1,11,11,0,0
7080313904,4,13,0,1,16,17,0,0
7080313905,1,20,0,0,17,21,0,0
7080313906,2,17,0,0,16,19,0,0
7080313907,1,8,0,1,9,9,0,0
7080313908,3,16,0,0,16,19,0,0
7080313909,9,18,0,0,27,27,0,0
7080313910,4,8,0,0,12,12,0,0
7080313911,2,17,0,1,19,19,0,0
7080313912,1,18,0,0,19,19,0,0
7080313913,7,38,0,0,42,45,0,0
7080313914,2,10,0,1,7,12,0,0
7080313915,13,11,0,0,16,24,0,0
7080314001,6,26,0,0,24,32,0,0
7080314002,2,21,0,0,18,23,0,0
7080314003,2,17,0,0,17,19,7,1
7080314004,3,14,0,0,15,17,0,0
7080314005,2,12,0,0,9,14,0,0
7080314006,1,11,0,1,9,12,0,0
7080314101,13,88,0,1,98,101,0,0
7080314102,3,16,0,1,19,19,0,0
7080314104,1,8,0,1,9,9,0,0
7080314105,3,12,0,0,14,15,0,0
7080314106,5,6,0,0,11,11,0,0
7080314107,2,9,0,1,11,11,0,0
7080314201,1,7,0,1,8,8,189,8
7080314202,0,10,0,1,10,10,0,0
7080314203,6,27,0,0,32,33,0,0
7080314204,9,26,0,0,33,35,0,0
7080314205,0,9,0,1,8,9,0,0
7080314206,1,21,0,0,19,22,0,0
7080314301,0,41,0,0,41,41,0,0
7080314302,4,76,0,1,78,80,0,0
7080314303,2,24,0,0,18,26,0,0
7080314401,8,97,0,0,105,105,45,2
7080314402,4,55,0,1,59,59,0,0
7080314403,12,87,0,0,94,99,0,0
7080314404,20,83,0,1,101,103,1600,80
7080314501,14,36,0,1,50,50,0,0
7080314502,0,7,0,1,6,7,28,1
7080314503,0,11,0,1,11,11,0,0
7080314504,2,24,0,0,25,26,0,0
7080314505,6,8,0,0,14,14,0,0
7080314506,3,31,0,0,33,34,0,0
7080314601,2,13,0,0,15,15,257,15
7080314701,1,25,0,0,26,26,150,25
7080314702,3,17,0,0,20,20,0,0
7080314703,4,12,0,0,16,16,0,0
7080314705,0,8,0,1,8,8,0,0
7080314706,4,14,0,0,18,18,0,0
7080314801,7,31,0,0,38,38,0,0
7080315101,2,41,0,0,39,43,0,0
7080315102,2,26,0,0,28,28,0,0
7080315201,4,33,0,0,37,37,430,36
7080315202,9,34,0,0,43,43,0,0
7080315203,0,7,0,1,6,7,0,0
7080315204,1,9,0,1,10,10,0,0
7080315205,1,11,0,1,10,12,0,0
7080315206,0,14,0,1,13,14,0,0
7080316101,7,61,0,0,68,68,270,1
7080316102,7,27,0,0,34,34,12,2
7080316401,12,56,0,2,67,68,0,0
7080316402,11,95,0,1,103,106,22,2
7080316403,9,53,0,0,61,62,650,62
7080316501,12,60,0,0,69,72,236,65
7080316502,11,69,0,0,78,80,0,0
7080316503,1,49,0,0,47,50,0,0
7080316504,0,83,0,1,83,83,0,0
7080316505,18,105,0,1,118,123,0,0
7080316506,7,36,0,0,42,43,1531,42
7080316507,6,36,0,0,42,42,0,0
7080316508,10,57,0,0,65,67,650,65
7080316509,0,65,0,0,63,65,0,0
7080316510,1,11,0,0,12,12,0,0
7080316601,6,65,0,1,70,71,0,0
7080316602,1,6,0,1,6,7,0,0
7080316701,5,35,0,1,40,40,0,0
7080316702,51,254,0,2,293,305,0,0
7080316704,5,50,0,0,55,55,0,0
7080316705,3,22,0,1,24,25,0,0
7080316801,0,14,0,0,14,14,0,0
7080316802,5,77,0,1,81,82,0,0
7080316803,17,89,0,1,106,106,0,0
7080316804,3,10,0,1,13,13,0,0
7080317101,11,95,0,1,105,106,0,0
7080317102,1,38,0,0,39,39,0,0
7080317103,12,105,0,1,115,117,0,0
7080317104,2,62,0,2,41,64,0,0
7080317105,8,27,0,0,34,35,20,1
7080317201,21,58,0,0,75,79,1475,79
7080317202,9,30,0,0,37,39,30,1
7080317203,10,59,0,0,69,69,0,0
7080317204,2,25,0,0,27,27,0,0
7080317205,3,21,0,1,24,24,300,3
7080317206,5,39,0,1,42,44,0,0
7080317207,4,12,0,1,4,16,0,0
7080317401,5,23,0,0,28,28,30,1
070803DC102,10,110,0,0,84,120,0,0
070803DC103,0,27,0,1,27,27,0,0
070803DC104,1,17,0,0,18,18,45,1
070803DC105,14,78,0,1,92,92,0,0
070803DC106,3,20,0,0,23,23,0,0
070803DC401,13,50,0,2,59,63,0,0
070803DC402,15,70,0,1,84,85,117,21
070803DC801,18,169,0,0,187,187,4260,187
070803ND801,0,12,0,1,12,12,0,0
7080411001,0,11,0,1,10,11,0,0
7080411002,12,0,0,1,12,12,40,1
7080411003,2,2,0,0,4,4,0,0
7080411004,1,23,0,1,21,24,0,0
7080411005,0,8,0,1,5,8,0,0
7080411006,8,2,0,0,7,10,0,0
7080411007,0,5,0,1,5,5,0,0
7080411008,0,13,0,1,12,13,0,0
7080412001,4,29,0,0,32,33,0,0
7080412002,27,5,0,1,24,32,90,7
7080412901,8,10,0,1,17,18,163,12
7080412902,0,20,0,1,18,20,0,0
7080412903,11,0,0,1,9,11,0,0
7080412904,0,12,0,1,10,12,0,0
7080413001,7,21,0,1,19,28,186,6
7080413002,1,15,0,1,15,16,0,0
7080413003,11,0,0,1,10,11,0,0
7080413004,0,13,0,1,9,13,0,0
7080413101,3,18,0,1,19,21,0,0
7080413102,10,2,0,1,10,12,0,0
7080413103,0,13,0,1,11,13,140,12
7080413104,10,4,0,1,10,14,0,0
7080413201,23,3,0,1,17,26,0,0
7080413202,7,23,0,0,26,30,54,18
7080413301,2,2,0,1,3,4,0,0
7080413302,2,1,0,1,2,3,0,0
7080413303,1,1,0,1,2,2,0,0
7080413304,2,0,0,1,2,2,0,0
7080413305,3,1,0,1,2,4,0,0
7080413306,1,4,0,0,4,5,0,0
7080413307,0,6,0,1,5,6,0,0
7080413308,0,2,0,1,2,2,0,0
7080413309,2,0,0,1,2,2,0,0
7080413310,6,2,0,1,7,8,30,1
7080413311,2,0,0,1,0,2,0,0
7080413312,1,2,0,1,1,3,0,0
7080413313,4,2,0,1,6,6,0,0
7080413314,1,2,0,1,3,3,0,0
7080413315,2,0,0,1,0,2,0,0
7080413316,1,1,0,1,2,2,0,0
7080413317,3,0,0,1,3,3,30,1
7080413318,1,3,0,1,4,4,0,0
7080413319,0,9,0,1,9,9,92,9
7080413320,5,6,0,1,8,11,0,0
7080413321,1,0,0,0,1,1,0,0
7080413401,9,10,0,1,15,19,0,0
7080413402,1,0,0,0,1,1,0,0
7080413403,1,1,0,1,1,2,0,0
7080413404,9,4,0,1,10,13,93,8
7080413405,4,10,0,1,11,14,10,2
7080413406,18,8,0,1,17,26,0,0
7080413407,0,35,0,1,30,35,0,0
7080413408,9,12,0,1,17,21,0,0
7080413409,0,27,0,1,21,27,15,1
7080413410,2,0,0,1,1,2,0,0
7080413411,1,1,0,1,1,2,0,0
7080413412,7,4,0,1,10,11,48,3
7080413413,1,14,0,1,13,15,205,1
7080413414,18,4,0,1,16,22,0,0
7080413601,1,10,0,1,10,11,0,0
7080413602,3,4,0,1,6,7,0,0
7080413603,8,9,0,1,14,17,0,0
7080413604,5,20,0,1,23,25,0,0
7080413607,10,5,0,1,14,15,0,0
7080413608,0,16,0,1,14,16,90,6
7080413609,3,8,0,1,10,11,232,6
7080413610,0,12,0,1,12,12,0,0
7080413611,3,9,0,1,12,12,0,0
7080413701,6,14,0,1,14,20,0,0
7080413702,0,22,0,1,19,22,0,0
7080413703,8,9,0,1,10,17,20,1
7080413704,0,17,0,0,13,17,0,0
7080413801,0,6,0,1,5,6,0,0
7080413802,12,12,0,1,17,24,0,0
7080413803,0,27,0,1,22,27,15,1
7080413804,4,1,0,1,4,5,0,0
7080413805,0,5,0,1,3,5,0,0
7080413806,5,7,0,1,12,12,0,0
7080413807,0,17,0,1,16,17,15,1
7080413901,3,3,0,1,5,6,0,0
7080413902,0,6,0,1,5,6,15,3
7080413903,0,11,0,1,11,11,0,0
7080413904,6,9,0,1,10,15,0,0
7080413905,6,10,0,1,15,16,0,0
7080413906,0,17,0,1,14,17,0,0
7080414001,2,1,0,1,2,3,0,0
7080414002,1,1,0,1,2,2,0,0
7080414003,0,2,0,1,1,2,0,0
7080414004,2,0,0,1,2,2,0,0
7080414005,2,1,0,1,3,3,0,0
7080414006,1,2,0,1,3,3,0,0
7080414007,0,2,0,1,2,2,0,0
7080414008,2,0,0,1,2,2,0,0
7080414009,1,1,0,1,2,2,3,1
7080414010,2,0,0,1,2,2,0,0
7080414011,0,7,0,1,5,7,0,0
7080414012,3,1,0,1,4,4,0,0
7080414013,0,2,0,1,1,2,0,0
7080414014,2,1,0,1,3,3,0,0
7080414015,0,3,0,1,3,3,0,0
7080414016,2,1,0,1,2,3,0,0
7080414017,3,0,0,1,2,3,0,0
7080414018,1,5,0,1,4,6,0,0
7080414019,3,3,0,1,2,6,0,0
7080414020,0,5,0,1,3,5,0,0
7080414021,13,11,0,1,24,24,0,0
7080414101,2,10,0,1,9,12,0,0
7080414102,3,1,0,1,3,4,0,0
7080414103,8,7,0,1,9,15,0,0
7080414104,4,7,0,1,9,11,0,0
7080414105,0,3,0,0,3,3,0,0
7080414106,2,28,0,1,29,30,10,2
7080414107,2,17,0,1,14,19,9,1
7080414201,8,5,0,1,11,13,0,0
7080414202,0,16,0,1,16,16,0,0
7080414203,7,5,0,1,7,12,0,0
7080414204,0,14,0,1,13,14,0,0
7080414301,6,9,0,1,12,15,0,0
7080414302,0,11,0,1,10,11,0,0
7080414303,15,26,0,1,25,41,850,13
7080414304,0,11,0,1,9,11,0,0
7080414305,5,6,0,1,6,11,0,0
7080414306,3,20,0,1,22,23,0,0
7080414307,0,21,0,1,19,21,0,0
7080414308,8,11,0,1,14,19,15,1
7080414309,0,20,0,1,15,20,0,0
7080414310,0,36,0,1,32,36,0,0
7080414401,0,27,0,1,24,27,230,23
7080414402,3,24,0,1,23,27,0,0
7080414403,1,14,0,1,12,15,0,0
7080414404,5,9,0,1,13,14,0,0
7080414405,15,14,0,1,18,29,0,0
7080414501,0,24,0,1,17,24,0,0
7080414502,4,14,0,1,18,18,0,0
7080414503,0,17,0,1,16,17,0,0
7080414504,3,16,0,1,19,19,0,0
7080414601,9,5,0,1,14,14,204,1
7080414602,0,12,0,1,11,12,0,0
7080414603,19,2,0,1,17,21,0,0
7080414604,0,21,0,1,14,21,0,0
7080414701,8,8,0,1,13,16,0,0
7080414702,0,18,0,1,16,18,0,0
7080414703,6,15,0,1,15,21,0,0
7080414704,16,6,0,1,19,22,0,0
7080414705,0,24,0,1,23,24,0,0
7080414801,16,11,0,1,21,27,45,1
7080414802,0,29,0,1,27,29,0,0
7080415001,2,3,0,0,4,5,0,0
7080415002,0,11,0,1,7,11,10,1
7080415003,6,3,0,1,4,9,0,0
7080415101,7,15,0,0,14,22,44,22
7080415102,1,6,0,1,7,7,0,0
7080415103,4,3,0,1,3,7,0,0
7080415104,3,16,0,1,7,19,0,0
7080415105,10,3,0,0,11,13,0,0
7080415106,1,2,0,1,2,3,0,0
7080415201,1,20,0,1,18,21,0,0
7080415202,4,9,0,0,6,13,0,0
7080415203,0,17,0,1,12,17,0,0
7080415204,2,9,0,1,10,11,0,0
7080415205,2,19,0,1,15,21,0,0
7080416501,0,13,0,1,11,13,0,0
7080416502,3,7,0,0,10,10,0,0
7080416503,0,10,0,1,10,10,0,0
7080416504,3,6,0,1,5,9,0,0
7080416505,0,11,0,1,8,11,5,1
7080416506,3,2,0,1,4,5,0,0
7080416601,0,10,0,1,10,10,0,0
7080416602,1,11,0,1,8,12,0,0
7080416603,1,10,0,1,7,11,0,0
7080416604,0,7,0,1,3,7,0,0
7080416605,0,4,0,1,4,4,0,0
7080416701,2,3,0,1,4,5,0,0
7080416702,1,7,0,1,4,8,0,0
7080416703,0,8,0,1,8,8,0,0
7080416704,0,7,0,1,5,7,0,0
7080416705,5,5,0,1,6,10,0,0
7080416706,2,3,0,1,5,5,0,0
7080416707,1,11,0,1,12,12,0,0
7080416801,0,7,0,1,5,7,1481,7
7080416802,8,0,0,1,8,8,0,0
7080416803,1,10,0,1,8,11,47,4
7080416804,1,3,0,1,3,4,0,0
7080416805,1,9,0,1,7,10,48,7
7080416806,1,6,0,1,7,7,0,0
7080417101,0,15,0,1,14,15,0,0
7080417102,2,12,0,1,11,14,0,0
7080417103,5,19,0,1,18,24,0,0
7080417201,15,16,0,1,22,31,0,0
7080417202,3,3,0,1,4,6,17,5
7080417203,0,18,0,1,17,18,10,2
7080417204,8,8,0,1,15,16,16,1
7080516701,1,3,0,1,3,4,0,0
7080603008,2,3,0,1,5,5,0,0
7080611001,0,5,0,1,1,5,0,0
7080612001,2,4,0,1,6,6,0,0
7080612002,0,5,0,1,5,5,0,0
7080612003,1,5,0,1,6,6,0,0
7080612004,3,2,0,1,1,5,0,0
7080612703,0,9,0,1,9,9,0,0
7080612901,0,5,0,1,2,5,0,0
7080613101,0,6,0,1,4,6,0,0
7080613102,0,5,0,1,5,5,0,0
7080613103,0,5,0,1,5,5,0,0
7080613104,1,9,0,1,7,10,0,0
7080613201,0,5,0,1,3,5,0,0
7080613301,2,3,0,1,1,5,0,0
7080613302,0,5,0,1,2,5,0,0
7080613303,1,10,0,0,7,11,0,0
7080613304,1,4,0,1,5,5,0,0
7080613306,2,3,0,1,5,5,0,0
7080613307,1,4,0,1,0,5,0,0
7080613401,0,5,0,1,3,5,0,0
7080613402,0,5,0,1,1,5,0,0
7080613403,1,6,0,1,0,7,0,0
7080613404,0,6,0,1,6,6,0,0
7080613405,1,3,0,1,0,4,0,0
7080613406,0,4,0,1,4,4,0,0
7080613701,0,5,0,1,0,5,0,0
7080613702,0,5,0,1,5,5,0,0
7080613703,0,5,0,1,5,5,0,0
7080613802,1,7,0,1,1,8,0,0
7080613902,1,4,0,1,5,5,0,0
7080613904,0,5,0,1,3,5,0,0
7080613905,1,10,0,1,11,11,0,0
7080613906,1,4,0,1,1,5,0,0
7080613908,0,7,0,1,7,7,0,0
7080614003,0,5,0,1,0,5,0,0
7080614004,0,5,0,1,5,5,0,0
7080614101,3,2,0,1,5,5,0,0
7080614102,0,6,0,1,2,6,0,0
7080614103,1,4,0,1,3,5,0,0
7080614104,0,5,0,1,3,5,0,0
7080614105,1,18,0,1,19,19,0,0
7080614106,0,5,0,1,1,5,100,5
7080614107,0,5,0,1,5,5,0,0
7080614201,1,4,0,1,0,5,0,0
7080614202,2,11,0,1,12,13,119,13
7080614203,1,4,0,1,0,5,62,5
7080614204,0,5,0,1,4,5,0,0
7080614205,1,3,0,1,4,4,0,0
7080614206,0,5,0,1,5,5,0,0
7080614207,1,4,0,1,2,5,0,0
7080614208,0,4,0,0,4,4,0,0
7080614302,0,4,0,1,0,4,0,0
7080614303,3,10,0,1,0,13,0,0
7080614304,0,5,0,1,1,5,0,0
7080614305,0,5,0,1,5,5,0,0
7080614401,0,9,0,1,0,9,63,9
7080614402,0,5,0,1,5,5,0,0
7080614403,1,4,0,1,5,5,0,0
7080614501,1,12,0,1,10,13,0,0
7080614502,0,5,0,1,5,5,0,0
7080614503,0,5,0,1,5,5,0,0
7080614601,0,5,0,1,5,5,0,0
7080614602,6,4,0,1,1,10,0,0
7080614603,0,5,0,1,5,5,0,0
7080614604,0,5,0,1,5,5,0,0
7080614605,0,6,0,1,6,6,0,0
7080614606,0,12,0,1,11,12,0,0
7080614701,0,5,0,1,2,5,0,0
7080614702,0,5,0,1,4,5,0,0
7080614802,0,5,0,1,2,5,0,0
7080614803,1,4,0,1,5,5,0,0
7080615001,0,4,0,1,4,4,0,0
7080615101,0,9,0,1,8,9,0,0
7080615201,0,5,0,1,5,5,0,0
7080616501,4,46,0,1,49,50,0,0
7080617101,2,5,0,1,7,7,0,0
7080617202,1,7,0,1,2,8,0,0
7080617203,2,8,0,1,6,10,0,0
070808DC101,3,21,0,1,23,24,0,0
070808DC201,3,15,0,0,15,18,0,0
070808DC301,7,24,0,0,31,31,0,0
070808DC401,8,14,0,1,18,22,0,0
070808DC501,2,16,0,0,13,18,0,0
070808DC701,6,20,0,2,24,26,0,0
7080900801,21,30,0,1,51,51,11,1
7080900802,48,112,0,2,158,160,48,4
7080913301,22,24,0,1,45,46,0,0
7080913601,7,15,0,0,22,22,0,0
7080913602,17,44,0,1,59,61,0,0
7080914101,3,41,0,1,44,44,2640,44
7080915201,43,99,0,2,137,142,74,6
7080916701,15,55,0,1,65,70,0,0
7080916702,14,22,0,1,36,36,0,0
7080916802,43,71,0,2,113,114,0,0
7080917201,14,20,0,1,34,34,0,0
7080917202,12,25,0,0,37,37,1,1
7080917203,8,21,0,1,27,29,0,0
070809DC101,12,24,0,1,35,36,0,0
070809DC401,34,63,0,0,86,97,0,0
7081014001,11,14,0,0,25,25,0,0
7090115401,15,0,0,0,15,15,0,0
7090115501,8,15,0,0,23,23,510,22
7090115502,42,3,0,0,44,45,305,19
7090115601,4,14,0,0,18,18,295,16
7090115602,0,51,0,0,51,51,0,0
7090115603,19,10,0,0,29,29,0,0
7090115604,25,2,0,0,26,27,72,6
7090115701,19,16,0,0,34,35,140,28
7090115702,13,16,0,0,24,29,0,0
7090115703,0,42,0,0,42,42,100,10
7090115704,2,40,0,0,40,42,0,0
7090115705,26,1,0,0,27,27,94,4
7090115706,23,2,0,0,23,25,0,0
7090115707,14,0,0,0,14,14,0,0
7090115708,22,1,0,0,22,23,0,0
7090115709,0,40,0,0,36,40,139,4
7090115801,1,62,0,0,58,63,0,0
7090115901,12,31,0,0,42,43,0,0
7090115902,0,28,0,0,28,28,115,6
7090116001,0,46,0,0,46,46,0,0
7090116101,1,32,0,0,32,33,335,12
7090116102,0,56,0,0,55,56,45,1
7090116103,26,0,0,0,26,26,0,0
7090116104,23,3,0,0,24,26,230,4
7090116105,27,1,0,0,28,28,0,0
7090116106,1,15,0,0,16,16,126,1
7090116201,1,55,0,0,50,56,84,17
7090116202,17,1,0,0,18,18,0,0
7090116401,5,17,0,0,22,22,700,15
7090116402,0,44,0,0,43,44,220,1
7090116901,30,0,0,0,30,30,13,3
7090116902,26,0,0,0,26,26,88,16
7090116903,68,1,0,0,68,69,0,0
7090116904,0,22,0,0,22,22,0,0
7090116905,2,70,0,0,72,72,44,4
7090117001,0,44,0,0,41,44,0,0
7090117002,22,2,0,0,24,24,0,0
7090117003,0,69,0,0,64,69,6,1
7090117004,21,3,0,0,24,24,0,0
7090117005,32,4,0,0,34,36,30,3
7090117301,24,13,0,0,37,37,0,0
7090117401,55,10,0,0,59,65,0,0
7090117402,14,20,0,0,34,34,0,0
7090117403,0,48,0,0,44,48,0,0
7090117404,0,63,0,0,62,63,127,22
7090117405,3,75,0,0,78,78,0,0
7090117406,12,12,0,0,21,24,0,0
7090117407,12,3,0,0,15,15,220,1
7090117501,2,48,0,0,49,50,0,0
7090117502,16,8,0,0,24,24,0,0
7090117503,20,24,0,0,39,44,0,0
7090117504,17,3,0,0,20,20,23,2
7090117601,30,19,0,0,49,49,0,0
7090117602,38,5,0,0,43,43,0,0
7090117701,2,106,0,0,108,108,0,0
7090117801,9,72,0,0,76,81,0,0
7090117802,85,0,0,0,84,85,0,0
7090117803,69,1,0,0,70,70,0,0
7090117901,32,0,0,0,32,32,200,22
7090117902,16,21,0,0,31,37,0,0
7090118001,0,27,0,0,27,27,0,0
7090118002,0,37,0,0,37,37,0,0
7090118101,40,0,0,0,40,40,0,0
7090118102,0,36,0,0,32,36,63,12
7090118103,38,1,0,0,38,39,0,0
7090118201,1,31,0,0,32,32,0,0
7090118202,39,0,0,0,39,39,0,0
7090118203,46,0,0,0,46,46,0,0
7090118204,0,48,0,0,48,48,600,30
7090118205,1,46,0,0,43,47,69,13
7090118206,0,52,0,0,52,52,6,2
7090118207,0,45,0,0,45,45,75,1
7090118208,22,2,0,0,24,24,0,0
7090118209,28,0,0,0,28,28,0,0
7090118210,24,1,0,0,25,25,0,0
7090118211,34,0,0,0,34,34,89,16
7090118212,36,0,0,0,36,36,100,2
7090118213,44,4,0,0,48,48,60,17
7090118401,0,42,0,0,37,42,0,0
7090118402,33,1,0,0,34,34,0,0
7090118403,1,49,0,0,49,50,162,17
7090118501,58,2,0,0,59,60,12,2
7090118502,0,53,0,0,53,53,10,1
7090118503,35,1,0,0,36,36,0,0
7090118504,3,61,0,0,59,64,21,3
7090118505,1,26,0,0,26,27,0,0
7090118506,44,1,0,0,44,45,0,0
7090118601,9,15,0,0,18,24,0,0
7090118602,15,0,0,0,15,15,0,0
7090119001,1,51,0,0,47,52,0,0
7090119002,40,5,0,0,44,45,0,0
7090119101,18,21,0,0,35,39,0,0
7090119201,33,1,0,0,34,34,0,0
7090119202,46,6,0,0,52,52,21,3
7090119203,0,44,0,0,42,44,0,0
7090119301,14,2,0,0,16,16,0,0
7090119302,1,44,0,0,45,45,0,0
7090119303,61,3,0,0,58,64,0,0
7090119401,0,47,0,0,42,47,99,17
7090119601,0,26,0,0,26,26,0,0
7090119602,0,39,0,0,39,39,0,0
7090119603,2,44,0,0,46,46,18,6
7090119604,1,39,0,0,40,40,0,0
7090119605,2,68,0,0,68,70,420,54
7090119606,24,2,0,0,26,26,70,1
7090119607,33,1,0,0,33,34,0,0
7090119608,48,0,0,0,48,48,0,0
7090119701,40,1,0,0,41,41,257,2
7090119702,0,91,0,0,91,91,55,1
7090119703,0,64,0,0,62,64,0,0
7090119704,1,37,0,0,35,38,0,0
7090119705,2,80,0,0,77,82,80,12
7090119706,60,1,0,0,61,61,918,51
7090119707,34,0,0,0,34,34,0,0
7090119801,47,1,0,0,48,48,65,13
7090119901,2,22,0,0,24,24,220,6
7090119902,27,0,0,0,27,27,12,2
7090120001,37,0,0,0,37,37,0,0
7090120002,1,29,0,0,30,30,45,1
7090120201,139,1,0,0,140,140,0,0
7090120301,1,61,0,0,62,62,0,0
7090120302,77,1,0,0,78,78,0,0
7090120303,0,51,0,0,51,51,60,1
7090120304,55,0,0,0,55,55,0,0
7090120305,72,0,0,0,72,72,321,44
7090120401,0,37,0,0,37,37,70,1
7090120402,6,132,0,0,137,138,0,0
7090120403,55,0,0,0,55,55,0,0
7090120404,2,123,0,0,117,125,40,1
7090120405,121,0,0,0,121,121,0,0
7090120501,28,3,0,0,31,31,0,0
7090120601,59,1,0,0,60,60,0,0
7090120602,1,44,0,0,45,45,0,0
7090120603,0,58,0,0,54,58,0,0
7090120604,0,55,0,0,55,55,5,1
7090120605,43,2,0,0,45,45,0,0
7090120606,60,6,0,0,66,66,0,0
7090120701,2,67,0,0,69,69,10,1
7090120702,1,94,0,0,93,95,327,2
7090120703,59,1,0,0,56,60,0,0
7090120801,2,27,0,0,28,29,60,1
7090120802,29,2,0,0,31,31,80,1
070901ND501,18,16,0,0,31,34,2535,31
070901ND502,8,19,0,0,25,27,144,24
070901ND601,2,30,0,0,32,32,10,2
070901ND602,24,4,0,0,28,28,38,3
070901ND603,0,36,0,0,36,36,400,21
7090215401,2,33,0,0,35,35,20,2
7090215402,24,17,0,0,41,41,396,18
7090215501,2,17,0,0,19,19,0,0
7090215502,0,14,0,0,14,14,0,0
7090215503,1,27,0,0,27,28,0,0
7090215601,14,5,0,0,18,19,0,0
7090215701,9,14,0,0,22,23,74,1
7090216001,6,25,0,0,30,31,0,0
7090216002,10,10,0,0,19,20,0,0
7090216003,9,1,0,0,9,10,0,0
7090216401,20,15,0,0,32,35,0,0
7090216402,0,6,0,0,6,6,0,0
7090218401,6,23,0,1,29,29,0,0
7090218501,0,15,0,1,12,15,0,0
7090219001,12,19,0,0,31,31,458,27
7090219301,0,20,0,0,20,20,0,0
7090219401,0,21,0,0,21,21,0,0
070902ND501,0,18,0,0,17,18,0,0
7090315401,13,40,0,1,52,53,1060,53
7090315402,0,2,0,1,2,2,0,0
7090315502,17,82,0,2,93,99,1881,99
7090315503,26,153,0,2,175,179,2300,178
7090315601,1,28,0,0,29,29,0,0
7090315602,10,59,0,0,68,69,0,0
7090315603,1,14,0,0,15,15,0,0
7090315604,3,12,0,0,15,15,0,0
7090315605,13,51,0,0,63,64,0,0
7090315701,3,28,0,0,30,31,460,30
7090315702,7,43,0,0,50,50,0,0
7090315703,5,63,0,0,68,68,650,65
7090315801,0,16,0,0,15,16,0,0
7090315802,22,101,0,1,123,123,3095,123
7090316002,1,8,0,1,9,9,0,0
7090316003,11,122,0,0,133,133,0,0
7090316101,0,18,0,1,16,18,0,0
7090316201,0,16,0,1,16,16,0,0
7090316301,7,43,0,1,42,50,600,50
7090316401,1,15,0,1,16,16,0,0
7090316403,5,21,0,0,24,26,0,0
7090316404,1,55,0,2,54,56,550,55
7090316405,14,68,0,0,77,82,1422,79
7090316406,0,11,0,1,11,11,0,0
7090316407,3,8,0,0,11,11,0,0
7090316408,8,84,0,1,89,92,0,0
7090316409,8,55,0,0,63,63,185,61
7090316410,15,82,0,2,87,97,0,0
7090316902,14,55,0,1,68,69,0,0
7090316903,9,85,0,2,94,94,0,0
7090316904,6,42,0,0,47,48,26,3
7090316905,21,84,0,0,100,105,612,2
7090316906,5,27,0,1,30,32,765,27
7090317001,0,26,0,0,26,26,73,25
7090317002,9,14,0,0,22,23,0,0
7090317003,4,34,0,0,37,38,0,0
7090317004,12,20,0,1,31,32,0,0
7090317301,0,9,0,1,9,9,0,0
7090317302,16,49,0,0,65,65,0,0
7090317303,0,10,0,0,6,10,0,0
7090317304,1,13,0,1,12,14,500,2
7090317401,10,24,0,0,34,34,323,2
7090317402,0,12,0,0,12,12,0,0
7090317602,17,6,0,0,21,23,0,0
7090317603,22,22,0,0,44,44,216,1
7090317702,8,21,0,0,26,29,0,0
7090317703,6,20,0,0,24,26,0,0
7090317704,0,7,0,1,7,7,0,0
7090317705,8,87,0,1,92,95,0,0
7090317706,1,12,0,0,12,13,0,0
7090317707,1,13,0,0,10,14,0,0
7090317801,0,17,0,1,17,17,0,0
7090317802,0,10,0,0,8,10,0,0
7090317901,0,10,0,1,10,10,0,0
7090317902,1,7,0,1,5,8,0,0
7090318101,0,64,0,0,63,64,534,64
7090318102,10,55,0,0,63,65,0,0
7090318402,5,38,0,1,43,43,0,0
7090318403,16,118,0,1,132,134,1169,119
7090318404,6,52,0,0,56,58,0,0
7090318405,9,65,0,1,70,74,0,0
7090318701,2,47,0,0,49,49,0,0
7090318702,2,13,0,0,14,15,0,0
7090318703,1,41,0,0,42,42,0,0
7090318801,5,22,0,1,25,27,0,0
7090318802,26,73,0,1,97,99,0,0
7090318901,6,66,0,0,71,72,30,1
7090319101,5,54,0,1,55,59,235,2
7090319201,8,79,0,0,76,87,0,0
7090319202,7,76,0,1,81,83,0,0
7090319203,8,77,0,0,81,85,0,0
7090319204,3,48,0,1,50,51,1680,51
7090319205,8,95,0,0,103,103,210,1
7090319206,4,92,0,0,94,96,20352,96
7090319207,7,65,0,1,68,72,1086,72
7090319208,4,45,0,1,49,49,0,0
7090319301,13,62,0,0,74,75,0,0
7090319302,3,25,0,0,28,28,937,28
7090319401,2,59,0,2,60,61,1860,60
7090319402,6,52,0,0,57,58,12,1
7090319601,7,64,0,1,68,71,0,0
7090319602,1,34,0,0,34,35,0,0
7090319603,14,63,0,0,74,77,0,0
7090319604,5,65,0,0,67,70,0,0
7090319605,8,38,0,1,44,46,0,0
7090319606,16,74,0,1,86,90,0,0
7090319607,4,33,0,0,35,37,0,0
7090319701,11,68,0,0,77,79,0,0
7090320002,3,9,0,1,12,12,0,0
7090320101,0,38,0,0,38,38,0,0
7090320201,5,10,0,1,15,15,0,0
7090320202,6,23,0,0,28,29,0,0
7090320203,20,30,0,0,50,50,0,0
7090320301,4,6,0,1,10,10,0,0
7090320302,0,29,0,0,29,29,0,0
7090320303,5,22,0,0,26,27,0,0
7090320304,1,11,0,1,11,12,0,0
7090320305,1,16,0,1,10,17,167,15
7090320306,0,14,0,1,14,14,282,14
7090320307,11,41,0,1,52,52,0,0
7090320308,0,15,0,1,14,15,0,0
7090320401,4,21,0,1,25,25,0,0
7090320402,5,10,0,1,12,15,0,0
7090320403,4,17,0,0,16,21,0,0
7090320404,0,15,0,1,15,15,0,0
7090320405,7,12,0,0,19,19,0,0
7090320406,2,11,0,0,13,13,0,0
7090320501,3,27,0,0,30,30,0,0
7090320502,1,24,0,1,23,25,0,0
7090320601,2,16,0,1,18,18,1221,18
7090320602,0,34,0,1,34,34,0,0
7090320603,2,10,0,1,12,12,0,0
7090320604,3,54,0,0,57,57,0,0
7090320801,0,14,0,0,14,14,0,0
7090320802,9,67,0,0,76,76,0,0
7090320803,19,30,0,0,48,49,616,49
7090320804,2,31,0,0,32,33,0,0
070903ND401,0,6,0,1,6,6,200,1
7090415401,1,11,0,1,11,12,15,1
7090415402,0,11,0,1,8,11,355,10
7090415403,5,0,0,1,5,5,0,0
7090415404,6,4,0,0,10,10,0,0
7090415405,3,8,0,1,10,11,0,0
7090415501,1,4,0,1,3,5,0,0
7090415502,1,11,0,1,11,12,0,0
7090415503,1,4,0,1,4,5,0,0
7090415504,0,4,0,1,3,4,0,0
7090415505,1,2,0,1,3,3,0,0
7090415506,0,3,0,1,3,3,3,1
7090415601,0,5,0,1,5,5,0,0
7090415602,5,6,0,1,9,11,0,0
7090415603,1,4,0,1,4,5,0,0
7090415604,3,8,0,1,11,11,0,0
7090415605,1,4,0,1,4,5,0,0
7090415701,0,10,0,1,9,10,0,0
7090415702,1,3,0,1,3,4,5,1
7090415703,1,4,0,1,4,5,10,1
7090415704,0,4,0,1,4,4,0,0
7090415705,1,4,0,1,4,5,240,4
7090415706,0,12,0,1,8,12,44,4
7090415707,1,10,0,1,11,11,0,0
7090415801,3,2,0,1,5,5,0,0
7090415802,0,6,0,1,5,6,0,0
7090415803,0,4,0,1,4,4,0,0
7090415804,0,5,0,1,5,5,0,0
7090415901,0,5,0,1,5,5,0,0
7090415902,1,14,0,1,14,15,0,0
7090415903,0,3,0,1,3,3,10,2
7090415905,1,11,0,1,12,12,0,0
7090415906,1,3,0,1,3,4,80,4
7090416001,1,10,0,0,9,11,120,3
7090416002,0,10,0,1,10,10,21,6
7090416003,3,5,0,1,6,8,0,0
7090416004,1,3,0,1,4,4,13,1
7090416101,0,4,0,1,4,4,25,3
7090416102,3,8,0,1,11,11,0,0
7090416103,0,4,0,0,4,4,0,0
7090416104,0,2,0,0,2,2,0,0
7090416105,0,8,0,1,8,8,0,0
7090416201,2,10,0,1,9,12,0,0
7090416202,2,14,0,1,12,16,0,0
7090416203,5,6,0,1,11,11,0,0
7090416204,3,6,0,1,9,9,0,0
7090416205,0,8,0,0,8,8,19,4
7090416206,0,8,0,1,8,8,5,1
7090416301,0,4,0,0,3,4,0,0
7090416302,0,5,0,1,4,5,0,0
7090416303,0,4,0,1,4,4,0,0
7090416401,3,6,0,1,6,9,0,0
7090416402,0,4,0,0,2,4,20,1
7090416403,0,2,0,1,2,2,30,1
7090416404,0,5,0,1,3,5,20,4
7090416405,0,3,0,1,3,3,11,3
7090416406,1,2,0,1,2,3,30,1
7090416901,2,11,0,1,11,13,0,0
7090416902,2,2,0,1,4,4,3,2
7090416903,0,5,0,1,5,5,18,1
7090416904,3,7,0,1,10,10,138,9
7090416905,0,11,0,1,8,11,14,5
7090417002,0,10,0,0,10,10,0,0
7090417003,0,20,0,1,9,20,0,0
7090417004,0,16,0,1,14,16,0,0
7090417005,2,5,0,1,7,7,0,0
7090417301,11,3,0,1,12,14,2616,12
7090417302,4,7,0,0,6,11,0,0
7090417303,4,8,0,1,8,12,0,0
7090417304,0,15,0,1,11,15,0,0
7090417305,5,10,0,1,14,15,0,0
7090417403,2,8,0,1,10,10,0,0
7090417404,0,17,0,1,16,17,0,0
7090417405,7,17,0,1,16,24,0,0
7090417406,0,19,0,1,18,19,0,0
7090417407,8,7,0,1,12,15,35,6
7090417408,2,19,0,1,19,21,0,0
7090417409,0,5,0,1,3,5,0,0
7090417501,10,1,0,1,7,11,547,8
7090417502,7,2,0,1,7,9,1,1
7090417503,1,12,0,1,8,13,35,4
7090417504,2,4,0,1,6,6,0,0
7090417505,0,19,0,1,18,19,0,0
7090417506,5,18,0,1,23,23,0,0
7090417601,12,1,0,1,11,13,0,0
7090417602,0,9,0,0,3,9,0,0
7090417603,6,0,0,1,3,6,0,0
7090417604,4,10,0,1,9,14,0,0
7090417605,0,9,0,1,9,9,0,0
7090417606,1,13,0,1,14,14,0,0
7090417607,0,14,0,1,13,14,0,0
7090417608,4,9,0,1,8,13,0,0
7090417701,9,0,0,1,9,9,10,1
7090417702,11,0,0,1,11,11,0,0
7090417703,10,7,0,1,9,17,0,0
7090417704,10,1,0,1,4,11,0,0
7090417705,7,4,0,0,7,11,0,0
7090417706,24,0,0,1,19,24,0,0
7090417707,14,11,0,1,16,25,0,0
7090417801,7,0,0,1,5,7,44,6
7090417802,1,8,0,1,5,9,0,0
7090417803,4,2,0,1,6,6,0,0
7090417804,1,10,0,1,9,11,0,0
7090417805,7,0,0,1,3,7,0,0
7090417806,1,11,0,1,9,12,0,0
7090417807,10,2,0,1,4,12,0,0
7090417808,0,15,0,1,8,15,0,0
7090417809,6,3,0,1,7,9,0,0
7090417810,0,12,0,1,8,12,0,0
7090417811,4,7,0,1,6,11,10,1
7090417812,0,14,0,1,13,14,0,0
7090417901,4,0,0,1,4,4,0,0
7090417902,0,5,0,1,3,5,24,4
7090417903,5,1,0,1,4,6,0,0
7090417904,1,6,0,1,5,7,0,0
7090418001,0,6,0,1,5,6,0,0
7090418002,4,3,0,1,4,7,0,0
7090418003,0,9,0,1,8,9,130,9
7090418005,2,9,0,1,7,11,0,0
7090418006,7,1,0,1,5,8,0,0
7090418101,4,8,0,1,3,12,0,0
7090418102,0,10,0,0,7,10,0,0
7090418103,1,6,0,0,5,7,0,0
7090418201,7,1,0,0,6,8,0,0
7090418202,0,13,0,1,11,13,166,12
7090418203,7,2,0,1,9,9,0,0
7090418204,0,13,0,0,4,13,0,0
7090418205,1,7,0,1,5,8,0,0
7090418206,9,0,0,1,9,9,220,1
7090418301,4,3,0,1,6,7,0,0
7090418302,0,10,0,1,10,10,20,4
7090418303,1,10,0,1,4,11,0,0
7090418304,0,8,0,0,7,8,0,0
7090418305,5,1,0,1,5,6,0,0
7090418306,0,6,0,1,4,6,0,0
7090418307,7,1,0,1,8,8,0,0
7090418308,1,9,0,1,8,10,0,0
7090418401,3,2,0,0,5,5,0,0
7090418403,0,13,0,1,8,13,0,0
7090418404,3,5,0,1,8,8,0,0
7090418405,0,4,0,1,4,4,22,1
7090418406,4,0,0,1,4,4,0,0
7090418407,4,2,0,1,4,6,0,0
7090418408,0,7,0,1,6,7,50,7
7090418409,1,5,0,1,6,6,0,0
7090418410,0,12,0,1,7,12,35,8
7090418501,13,2,0,0,6,15,0,0
7090418502,5,23,0,1,17,28,0,0
7090418503,5,0,0,1,0,5,0,0
7090418504,11,0,0,1,7,11,0,0
7090418505,2,8,0,1,7,10,15,3
7090418506,18,4,0,1,8,22,0,0
7090418507,10,13,0,0,15,23,10,2
7090418601,14,0,0,1,9,14,0,0
7090418602,14,12,0,1,15,26,14,2
7090418703,22,0,0,1,10,22,0,0
7090418704,18,2,0,0,10,20,0,0
7090418901,2,11,0,1,13,13,154,7
7090418902,5,5,0,1,8,10,0,0
7090418903,1,10,0,1,11,11,0,0
7090419001,4,12,0,0,9,16,0,0
7090419002,5,2,0,1,6,7,0,0
7090419003,0,8,0,1,8,8,108,3
7090419004,2,7,0,1,7,9,0,0
7090419005,8,3,0,1,11,11,0,0
7090419006,3,19,0,1,20,22,0,0
7090419101,0,5,0,1,4,5,0,0
7090419102,1,3,0,1,3,4,0,0
7090419103,4,2,0,1,6,6,0,0
7090419104,0,9,0,0,9,9,15,1
7090419105,1,7,0,1,5,8,0,0
7090419201,2,10,0,1,11,12,156,7
7090419202,2,12,0,1,14,14,255,5
7090419203,2,5,0,1,5,7,0,0
7090419301,9,7,0,1,12,16,51,7
7090419302,0,17,0,1,13,17,0,0
7090419303,3,5,0,1,8,8,0,0
7090419304,0,7,0,0,6,7,0,0
7090419305,3,2,0,1,4,5,0,0
7090419306,1,5,0,1,6,6,0,0
7090419401,4,1,0,1,5,5,0,0
7090419402,2,11,0,1,10,13,0,0
7090419403,4,8,0,1,11,12,0,0
7090419404,6,3,0,1,9,9,0,0
7090419405,2,4,0,1,6,6,0,0
7090419501,7,3,0,1,8,10,0,0
7090419601,9,2,0,1,5,11,0,0
7090419602,0,16,0,1,8,16,9,3
7090419603,4,4,0,1,3,8,0,0
7090419604,0,6,0,1,6,6,0,0
7090419605,0,14,0,1,14,14,0,0
7090419606,4,0,0,1,3,4,0,0
7090419607,0,4,0,0,3,4,0,0
7090419608,1,13,0,1,14,14,0,0
7090419701,19,3,0,1,22,22,0,0
7090419702,15,3,0,1,17,18,0,0
7090419703,0,18,0,1,18,18,0,0
7090419801,17,0,0,1,8,17,0,0
7090419802,3,15,0,1,17,18,0,0
7090419803,3,29,0,1,25,32,0,0
7090419804,27,1,0,1,21,28,5,1
7090419805,2,30,0,1,29,32,0,0
7090419901,18,0,0,1,18,18,0,0
7090419902,12,7,0,1,19,19,0,0
7090419903,13,1,0,1,14,14,0,0
7090419904,13,7,0,0,16,20,220,20
7090419905,4,0,0,0,2,4,0,0
7090419906,2,4,0,1,6,6,0,0
7090420001,14,0,0,0,2,14,0,0
7090420002,4,3,0,0,7,7,0,0
7090420003,19,6,0,0,24,25,0,0
7090420004,0,25,0,1,15,25,0,0
7090420101,31,0,0,0,23,31,0,0
7090420102,22,7,0,0,26,29,0,0
7090420103,40,0,0,1,19,40,0,0
7090420104,25,18,0,1,24,43,0,0
7090420201,22,0,0,1,14,22,0,0
7090420202,22,12,0,1,22,34,0,0
7090420203,19,0,0,1,16,19,0,0
7090420204,1,35,0,1,35,36,0,0
7090420301,0,19,0,1,17,19,0,0
7090420302,13,3,0,1,11,16,0,0
7090420303,4,4,0,1,4,8,0,0
7090420304,9,0,0,1,9,9,459,9
7090420305,10,0,0,1,4,10,0,0
7090420306,3,13,0,1,14,16,20,1
7090420307,5,7,0,1,6,12,15,1
7090420308,14,4,0,1,14,18,0,0
7090420309,0,18,0,1,18,18,68,17
7090420310,0,11,0,1,10,11,462,11
7090420401,10,10,0,1,18,20,25,1
7090420402,3,25,0,1,26,28,30,1
7090420403,16,0,0,1,11,16,0,0
7090420404,1,22,0,1,20,23,0,0
7090420501,0,3,0,1,3,3,0,0
7090420502,2,1,0,0,2,3,0,0
7090420503,1,10,0,1,10,11,0,0
7090420504,3,11,0,1,13,14,63,11
7090420505,0,16,0,1,14,16,75,12
7090420506,2,19,0,1,17,21,0,0
7090420507,1,20,0,1,20,21,0,0
7090420508,3,2,0,1,3,5,0,0
7090420509,0,7,0,1,7,7,0,0
7090420510,7,6,0,1,6,13,0,0
7090420511,1,12,0,1,12,13,0,0
7090420601,0,7,0,1,5,7,0,0
7090420602,2,2,0,1,3,4,0,0
7090420603,0,12,0,1,12,12,0,0
7090420604,4,6,0,1,9,10,16,3
7090420605,0,5,0,1,5,5,0,0
7090420606,1,6,0,1,5,7,0,0
7090420607,6,3,0,1,8,9,0,0
7090420608,2,4,0,1,4,6,25,5
7090420609,0,11,0,1,11,11,0,0
7090420610,4,9,0,1,13,13,160,4
7090420611,1,6,0,1,6,7,15,1
7090420612,0,10,0,1,9,10,0,0
7090420613,2,9,0,1,8,11,15,3
7090420701,7,0,0,0,4,7,0,0
7090420702,13,0,0,1,10,13,137,10
7090420703,7,3,0,1,8,10,0,0
7090420704,1,6,0,0,5,7,0,0
7090420705,18,3,0,1,21,21,0,0
7090420706,2,6,0,1,5,8,0,0
7090420707,10,9,0,1,12,19,0,0
7090420708,2,11,0,1,12,13,0,0
7090420709,14,0,0,0,9,14,0,0
7090420710,7,0,0,0,4,7,250,7
7090420711,12,1,0,1,8,13,0,0
7090420801,7,0,0,0,3,7,0,0
7090420802,11,16,0,1,22,27,630,9
7090420803,1,22,0,0,22,23,13,4
7090515501,0,4,0,0,3,4,0,0
7090515601,0,4,0,1,4,4,0,0
7090515602,0,6,0,1,6,6,0,0
7090515701,0,5,0,1,5,5,0,0
7090515801,0,2,0,1,2,2,0,0
7090516201,0,4,0,0,4,4,0,0
7090516202,0,17,0,1,17,17,0,0
7090517001,0,5,0,1,2,5,0,0
7090615601,0,7,0,1,7,7,0,0
7090616101,0,10,0,1,10,10,0,0
7090616201,0,10,0,1,9,10,0,0
7090616401,0,5,0,1,5,5,0,0
7090616402,0,4,0,0,4,4,0,0
7090616901,0,5,0,1,0,5,0,0
7090616902,0,5,0,1,4,5,0,0
7090616903,0,5,0,1,5,5,175,5
7090617001,3,2,0,1,0,5,0,0
7090617002,0,5,0,1,5,5,0,0
7090617003,1,5,0,1,6,6,0,0
7090617301,0,5,0,1,5,5,0,0
7090617302,1,4,0,1,4,5,10,1
7090617303,0,6,0,1,6,6,0,0
7090617304,0,6,0,1,4,6,0,0
7090617401,1,11,0,1,6,12,0,0
7090617402,0,5,0,1,2,5,75,5
7090617403,2,5,0,1,3,7,0,0
7090617404,0,5,0,1,4,5,0,0
7090617406,1,4,0,1,0,5,0,0
7090617501,0,5,0,1,5,5,0,0
7090617502,0,8,0,1,8,8,207,7
7090617503,0,5,0,1,2,5,15,5
7090617601,3,3,0,1,6,6,108,6
7090617701,0,6,0,1,6,6,0,0
7090617703,4,6,0,1,6,10,0,0
7090617704,0,5,0,1,5,5,0,0
7090617705,0,6,0,1,0,6,60,5
7090617706,0,5,0,1,4,5,0,0
7090617707,1,8,0,1,2,9,0,0
7090617708,1,4,0,1,5,5,0,0
7090617711,1,6,0,1,5,7,0,0
7090617712,0,11,0,1,11,11,0,0
7090617713,0,7,0,1,0,7,0,0
7090617714,0,5,0,1,5,5,0,0
7090617716,1,6,0,0,7,7,70,7
7090617717,1,9,0,1,7,10,0,0
7090617718,2,4,0,1,6,6,0,0
7090617719,0,21,0,1,10,21,0,0
7090617720,0,5,0,1,5,5,0,0
7090617801,0,5,0,1,5,5,0,0
7090617802,0,5,0,1,4,5,80,5
7090617803,1,4,0,1,5,5,0,0
7090617804,2,4,0,1,6,6,0,0
7090617805,1,4,0,1,0,5,0,0
7090617806,3,2,0,1,0,5,0,0
7090617901,0,5,0,1,5,5,0,0
7090618101,1,4,0,1,4,5,120,5
7090618102,1,4,0,1,5,5,0,0
7090618103,0,5,0,1,5,5,0,0
7090618104,0,5,0,1,4,5,0,0
7090618301,1,4,0,1,4,5,0,0
7090618302,1,4,0,1,5,5,0,0
7090618501,3,2,0,1,1,5,0,0
7090618502,0,5,0,1,4,5,0,0
7090618601,0,5,0,0,0,5,0,0
7090618603,1,4,0,1,4,5,0,0
7090618604,3,2,0,1,2,5,0,0
7090618605,0,5,0,1,0,5,0,0
7090618606,0,5,0,1,4,5,0,0
7090618607,0,5,0,1,0,5,0,0
7090618701,0,4,0,0,4,4,43,4
7090618702,0,6,0,1,6,6,0,0
7090618703,0,14,0,1,5,14,0,0
7090618704,0,5,0,1,1,5,0,0
7090618705,1,10,0,1,1,11,0,0
7090618802,2,5,0,1,3,7,0,0
7090618803,0,5,0,1,5,5,0,0
7090618804,1,6,0,1,7,7,0,0
7090618805,1,11,0,1,8,12,0,0
7090618806,1,5,0,1,0,6,90,5
7090618807,1,4,0,1,0,5,0,0
7090618901,0,5,0,1,5,5,0,0
7090618902,1,5,0,1,5,6,0,0
7090618903,1,7,0,1,8,8,0,0
7090619201,0,8,0,0,8,8,0,0
7090619501,0,6,0,1,5,6,0,0
7090619502,0,5,0,1,5,5,0,0
7090619503,0,8,0,1,8,8,112,8
7090619602,0,5,0,1,5,5,0,0
7090619603,0,5,0,1,5,5,0,0
7090619604,1,8,0,1,6,9,0,0
7090619605,0,5,0,1,5,5,0,0
7090619606,0,5,0,1,5,5,0,0
7090619607,0,3,0,0,3,3,0,0
7090619608,0,10,0,0,10,10,0,0
7090619701,0,7,0,1,1,7,0,0
7090619702,0,5,0,1,5,5,0,0
7090619803,0,5,0,1,5,5,0,0
7090619804,3,6,0,1,6,9,0,0
7090619805,0,6,0,1,6,6,0,0
7090619807,1,4,0,1,1,5,0,0
7090619901,3,9,0,1,5,12,0,0
7090620001,0,9,0,1,7,9,0,0
7090620101,3,8,0,1,0,11,0,0
7090620102,3,2,0,1,1,5,0,0
7090620103,2,2,0,0,0,4,0,0
7090620104,0,5,0,1,2,5,0,0
7090620105,1,4,0,1,5,5,0,0
7090620106,1,5,0,1,4,6,0,0
7090620107,1,3,0,0,1,4,0,0
7090620108,5,23,0,0,27,28,1,1
7090620109,3,4,0,1,2,7,0,0
7090620110,0,12,0,1,0,12,0,0
7090620201,10,6,0,1,8,16,0,0
7090620202,0,5,0,1,4,5,0,0
7090620203,0,5,0,1,5,5,0,0
7090620204,2,3,0,1,5,5,0,0
7090620205,3,4,0,1,6,7,0,0
7090620206,0,6,0,1,6,6,0,0
7090620207,1,6,0,1,7,7,0,0
7090620208,0,5,0,1,5,5,54,5
7090620209,2,3,0,1,0,5,0,0
7090620210,1,4,0,1,4,5,0,0
7090620211,0,5,0,1,4,5,0,0
7090620212,0,5,0,1,5,5,0,0
7090620301,0,9,0,1,9,9,0,0
7090620302,1,10,0,0,11,11,0,0
7090620402,0,5,0,1,4,5,0,0
7090620403,5,0,0,1,0,5,0,0
7090620405,0,5,0,1,5,5,0,0
7090620406,2,3,0,1,5,5,0,0
7090620407,1,4,0,1,4,5,0,0
7090620408,0,5,0,1,4,5,0,0
7090620409,2,4,0,1,6,6,0,0
7090620410,1,4,0,1,5,5,0,0
7090620411,2,4,0,1,6,6,0,0
7090620412,1,4,0,1,5,5,0,0
7090620413,5,1,0,1,0,6,0,0
7090620501,3,6,0,1,3,9,0,0
7090620601,3,10,0,1,12,13,0,0
7090620602,0,10,0,1,10,10,0,0
7090620701,2,7,0,1,6,9,0,0
7090620702,1,5,0,1,4,6,0,0
7090620703,2,3,0,1,0,5,0,0
7090620704,3,2,0,1,5,5,0,0
7090620705,0,5,0,1,5,5,0,0
7090620706,5,0,0,1,0,5,0,0
7090620801,0,5,0,1,1,5,0,0
7090620802,0,5,0,1,3,5,150,5
7090620803,3,2,0,1,5,5,0,0
7090915901,45,73,0,2,114,118,40,1
7090915902,25,36,0,1,55,61,24,2
7090916901,47,79,0,2,123,126,0,0
7090917001,13,17,0,0,30,30,0,0
7090918402,48,75,0,2,121,123,33,2
7090918501,45,75,0,2,118,120,0,0
7090920301,18,29,0,1,44,47,0,0
